Season,Game,Team,Pd1,Pd2,Pd3,OT,SO Win,Total
2009,20001,NYR,0,1,1,0,0,2
2009,20001,TBL,0,0,1,0,0,1
2009,20002,OTT,1,2,0,0,0,3
2009,20002,PIT,1,1,1,1,0,4
2009,20003,NYR,0,2,0,0,0,2
2009,20003,TBL,1,0,0,0,0,1
2009,20004,OTT,0,1,2,0,0,3
2009,20004,PIT,0,0,1,0,0,1
2009,20005,DET,0,1,1,0,0,2
2009,20005,TOR,1,1,1,0,0,3
2009,20006,BOS,2,1,2,0,0,5
2009,20006,COL,2,1,1,0,0,4
2009,20007,CGY,0,0,0,0,0,0
2009,20007,VAN,1,2,3,0,0,6
2009,20008,ANA,0,0,1,0,0,1
2009,20008,SJS,0,2,2,0,0,4
2009,20009,NJD,1,1,0,0,0,2
2009,20009,NYI,1,0,0,0,0,1
2009,20010,CHI,1,0,1,0,0,2
2009,20010,NYR,1,2,1,0,0,4
2009,20011,CAR,2,2,2,0,0,6
2009,20011,FLA,2,1,1,0,0,4
2009,20012,BUF,1,0,0,0,1,2
2009,20012,MTL,1,0,0,0,0,1
2009,20013,ATL,3,1,3,0,0,7
2009,20013,WSH,1,3,0,0,0,4
2009,20014,NSH,1,1,0,0,0,2
2009,20014,STL,2,3,0,0,0,5
2009,20015,CBJ,1,0,3,1,0,5
2009,20015,DAL,0,2,2,0,0,4
2009,20016,MTL,2,4,0,0,0,6
2009,20016,TOR,0,1,0,0,0,1
2009,20017,DET,1,0,2,0,0,3
2009,20017,OTT,1,1,0,0,0,2
2009,20018,NYI,4,0,1,0,0,5
2009,20018,STL,1,0,1,0,0,2
2009,20019,NYR,4,0,0,0,0,4
2009,20019,PHI,0,2,1,0,0,3
2009,20020,CHI,2,0,0,0,0,2
2009,20020,WSH,1,1,2,0,0,4
2009,20021,ATL,1,1,0,0,0,2
2009,20021,FLA,1,1,0,1,0,3
2009,20022,NJD,0,0,1,1,0,2
2009,20022,PIT,1,0,0,0,0,1
2009,20023,CAR,0,1,2,1,0,4
2009,20023,TBL,2,1,0,0,0,3
2009,20024,DAL,1,0,0,0,0,1
2009,20024,NSH,2,0,1,0,0,3
2009,20025,BOS,1,0,2,0,0,3
2009,20025,MIN,1,3,0,0,0,4
2009,20026,CGY,3,1,0,0,0,4
2009,20026,VAN,1,2,1,1,0,5
2009,20027,CBJ,0,1,0,0,0,1
2009,20027,PHX,2,1,0,0,0,3
2009,20028,LAK,1,0,0,0,0,1
2009,20028,SJS,0,2,1,0,0,3
2009,20029,COL,0,1,1,0,0,2
2009,20029,EDM,1,0,2,0,0,3
2009,20030,ANA,0,1,1,0,0,2
2009,20030,PHX,1,2,1,0,0,4
2009,20031,LAK,0,0,0,0,0,0
2009,20031,SJS,0,1,0,0,0,1
2009,20032,STL,0,3,1,0,1,5
2009,20032,TOR,3,1,0,0,0,4
2009,20033,BUF,1,4,2,0,0,7
2009,20033,NYI,0,0,1,0,0,1
2009,20034,NJD,0,1,0,0,0,1
2009,20034,NYR,1,1,2,0,0,4
2009,20035,MTL,0,1,4,0,0,5
2009,20035,PHI,0,2,1,0,0,3
2009,20036,VAN,1,0,0,0,0,1
2009,20036,WSH,2,3,0,0,0,5
2009,20037,CAR,0,1,0,0,0,1
2009,20037,DET,1,1,1,0,0,3
2009,20038,CHI,1,1,0,0,0,2
2009,20038,NSH,2,0,0,0,1,3
2009,20039,PHI,0,2,0,0,0,2
2009,20039,PIT,0,2,0,1,0,3
2009,20040,ATL,0,1,1,0,0,2
2009,20040,MIN,1,0,3,0,0,4
2009,20041,CGY,3,0,2,0,0,5
2009,20041,COL,2,1,1,0,0,4
2009,20042,ANA,2,0,1,0,0,3
2009,20042,LAK,1,2,3,0,0,6
2009,20043,CBJ,1,1,0,0,0,2
2009,20043,SJS,0,3,2,0,0,5
2009,20044,BUF,0,2,1,0,0,3
2009,20044,NYR,1,0,0,0,0,1
2009,20045,BOS,0,1,2,0,0,3
2009,20045,MTL,3,0,0,0,1,4
2009,20046,CHI,0,2,2,0,0,4
2009,20046,PHX,0,1,0,0,0,1
2009,20047,DAL,1,3,2,0,0,6
2009,20047,NSH,0,3,1,0,0,4
2009,20048,ANA,1,1,0,0,0,2
2009,20048,EDM,1,1,1,0,0,3
2009,20049,ATL,0,0,0,0,0,0
2009,20049,NJD,0,1,0,0,0,1
2009,20050,PIT,2,1,0,0,0,3
2009,20050,WSH,0,1,3,0,0,4
2009,20051,NYI,1,1,1,1,0,4
2009,20051,TBL,0,0,3,0,0,3
2009,20052,FLA,0,2,0,0,0,2
2009,20052,MIN,1,3,2,0,0,6
2009,20053,DET,1,2,0,0,0,3
2009,20053,VAN,2,0,1,1,0,4
2009,20054,DAL,1,0,0,0,0,1
2009,20054,STL,2,3,1,0,0,6
2009,20055,COL,2,2,1,0,0,5
2009,20055,PHI,0,2,0,0,0,2
2009,20056,OTT,3,1,2,0,0,6
2009,20056,PHX,0,0,3,0,0,3
2009,20057,NYR,0,0,0,0,1,1
2009,20057,TOR,0,0,0,0,0,0
2009,20058,CBJ,3,1,1,0,0,5
2009,20058,NSH,0,2,1,0,0,3
2009,20059,BUF,3,1,1,0,0,5
2009,20059,VAN,0,1,1,0,0,2
2009,20060,CGY,1,1,1,0,0,3
2009,20060,EDM,1,3,0,0,0,4
2009,20061,ANA,1,1,2,0,0,4
2009,20061,SJS,0,0,0,0,0,0
2009,20062,CAR,0,3,0,0,0,3
2009,20062,LAK,1,1,1,1,0,4
2009,20063,COL,2,3,0,0,0,5
2009,20063,DAL,1,1,2,0,0,4
2009,20064,MTL,2,2,0,0,0,4
2009,20064,PHX,0,0,1,0,0,1
2009,20065,BOS,1,2,1,0,0,4
2009,20065,OTT,1,1,0,0,0,2
2009,20066,PIT,1,1,2,0,0,4
2009,20066,TOR,1,0,0,0,0,1
2009,20067,NJD,1,0,2,0,1,4
2009,20067,WSH,1,1,1,0,0,3
2009,20068,ATL,2,0,0,0,1,3
2009,20068,BUF,0,1,1,0,0,2
2009,20069,FLA,1,1,0,0,0,2
2009,20069,NYI,0,0,0,0,0,0
2009,20070,DET,2,1,1,1,0,5
2009,20070,NYR,1,1,2,0,0,4
2009,20071,MIN,0,0,0,0,1,1
2009,20071,TBL,0,0,0,0,0,0
2009,20072,CBJ,0,2,1,0,0,3
2009,20072,NSH,3,1,2,0,0,6
2009,20073,CHI,1,1,1,0,0,3
2009,20073,STL,0,1,2,0,1,4
2009,20074,CGY,2,0,0,0,0,2
2009,20074,EDM,0,3,0,0,0,3
2009,20075,PHI,1,2,1,0,0,4
2009,20075,SJS,0,2,2,1,0,5
2009,20076,CHI,2,0,2,0,0,4
2009,20076,VAN,1,0,1,0,0,2
2009,20077,ANA,0,1,0,0,0,1
2009,20077,CAR,1,1,1,0,0,3
2009,20078,BOS,0,1,0,0,0,1
2009,20078,PIT,1,0,0,0,1,2
2009,20079,DAL,0,1,1,0,0,2
2009,20079,NYR,1,0,0,0,0,1
2009,20080,MTL,0,1,2,0,0,3
2009,20080,FLA,0,0,1,0,0,1
2009,20081,COL,1,3,0,0,0,4
2009,20081,LAK,1,1,1,0,0,3
2009,20082,BOS,1,1,0,0,0,2
2009,20082,BUF,0,1,1,0,1,3
2009,20083,ANA,2,0,0,0,1,3
2009,20083,TOR,0,1,1,0,0,2
2009,20084,CBJ,2,1,1,0,0,4
2009,20084,VAN,1,0,1,0,0,2
2009,20085,ATL,0,0,2,0,0,2
2009,20085,TBL,1,1,0,1,0,3
2009,20086,CGY,0,2,0,0,0,2
2009,20086,WSH,1,0,0,0,0,1
2009,20087,FLA,2,1,0,0,0,3
2009,20087,OTT,0,1,0,0,0,1
2009,20088,DAL,0,0,0,0,0,0
2009,20088,NJD,1,2,2,0,0,5
2009,20089,PHI,3,1,2,0,0,6
2009,20089,SJS,4,1,1,0,1,7
2009,20090,DET,1,2,1,0,0,4
2009,20090,STL,0,1,2,0,0,3
2009,20091,CHI,2,1,0,0,0,3
2009,20091,EDM,0,0,0,0,0,0
2009,20092,BOS,2,0,0,0,0,2
2009,20092,TOR,0,2,2,0,0,4
2009,20093,DAL,3,2,0,0,0,5
2009,20093,NYI,0,1,2,0,0,3
2009,20094,CAR,1,0,0,0,0,1
2009,20094,PIT,0,0,4,0,0,4
2009,20095,CGY,0,1,4,0,0,5
2009,20095,NSH,0,3,0,0,0,3
2009,20096,BUF,1,0,2,1,0,4
2009,20096,MIN,0,2,1,0,0,3
2009,20097,COL,0,3,1,0,0,4
2009,20097,EDM,0,1,0,0,0,1
2009,20098,PHX,0,0,2,0,0,2
2009,20098,WSH,0,1,0,0,0,1
2009,20099,ANA,1,3,0,0,0,4
2009,20099,OTT,0,0,3,0,0,3
2009,20100,NJD,3,0,0,0,0,3
2009,20100,PHI,2,2,2,0,0,6
2009,20101,CBJ,1,0,0,0,0,1
2009,20101,NYR,0,2,1,0,0,3
2009,20102,FLA,3,1,0,0,0,4
2009,20102,SJS,1,2,0,0,0,3
2009,20103,ATL,1,0,2,0,0,3
2009,20103,DET,2,2,1,0,0,5
2009,20104,LAK,2,0,2,0,0,4
2009,20104,STL,0,0,0,0,0,0
2009,20105,ATL,2,1,1,0,0,4
2009,20105,BOS,0,3,2,0,0,5
2009,20106,OTT,0,1,1,0,0,2
2009,20106,TOR,1,1,1,0,0,3
2009,20107,ANA,2,3,1,0,0,6
2009,20107,MTL,2,1,1,0,0,4
2009,20108,CAR,2,1,1,0,0,4
2009,20108,NYI,0,1,2,0,0,3
2009,20109,NYR,0,0,2,0,1,3
2009,20109,PIT,1,1,0,0,0,2
2009,20110,NJD,0,2,0,0,0,2
2009,20110,PHI,1,1,0,1,0,3
2009,20111,SJS,0,2,1,0,0,3
2009,20111,TBL,0,0,0,0,0,0
2009,20112,LAK,0,2,2,0,0,4
2009,20112,NSH,3,0,2,0,0,5
2009,20113,CBJ,0,0,1,0,0,1
2009,20113,MIN,1,0,1,0,0,2
2009,20114,DAL,2,1,2,0,0,5
2009,20114,WSH,2,2,1,1,0,6
2009,20115,CHI,1,3,1,0,0,5
2009,20115,DET,1,1,3,0,1,6
2009,20116,FLA,0,0,0,0,0,0
2009,20116,STL,1,2,1,0,0,4
2009,20117,BUF,0,1,0,0,0,1
2009,20117,COL,0,0,1,0,1,2
2009,20118,EDM,0,3,0,0,0,3
2009,20118,VAN,1,2,3,0,0,6
2009,20119,CGY,2,1,1,0,0,4
2009,20119,PHX,1,0,0,0,0,1
2009,20120,BUF,0,0,2,0,0,2
2009,20120,OTT,1,3,1,0,0,5
2009,20121,NYI,1,0,1,0,0,2
2009,20121,NYR,1,1,2,0,0,4
2009,20122,ANA,1,0,2,0,0,3
2009,20122,CBJ,1,1,0,0,0,2
2009,20123,CHI,1,0,1,0,0,2
2009,20123,MIN,1,2,0,0,0,3
2009,20124,BOS,0,0,0,1,0,1
2009,20124,EDM,0,0,0,0,0,0
2009,20125,DET,1,1,1,0,1,4
2009,20125,LAK,1,1,1,0,0,3
2009,20126,NSH,1,1,1,0,0,3
2009,20126,WSH,2,0,1,0,1,4
2009,20127,ATL,0,0,0,0,0,0
2009,20127,PHI,1,2,4,0,0,7
2009,20128,TBL,2,1,0,0,0,3
2009,20128,TOR,1,1,0,0,0,2
2009,20129,MTL,2,0,0,0,1,3
2009,20129,CAR,1,0,1,0,0,2
2009,20130,CGY,0,0,3,0,0,3
2009,20130,COL,0,0,0,0,0,0
2009,20131,BOS,1,0,0,0,0,1
2009,20131,VAN,0,0,0,0,0,0
2009,20132,PIT,0,0,1,0,0,1
2009,20132,SJS,1,0,1,0,0,2
2009,20133,NJD,2,2,1,0,0,5
2009,20133,TOR,0,3,2,0,1,6
2009,20134,DAL,3,1,0,0,0,4
2009,20134,MIN,1,0,1,0,0,2
2009,20135,ANA,1,1,2,1,0,5
2009,20135,DET,1,2,1,0,0,4
2009,20136,BUF,1,1,0,0,0,2
2009,20136,TBL,3,2,0,0,0,5
2009,20137,ATL,1,0,1,0,0,2
2009,20137,NYR,1,0,2,0,0,3
2009,20138,NYI,1,0,1,0,0,2
2009,20138,PHI,2,0,0,1,0,3
2009,20139,FLA,1,0,0,0,0,1
2009,20139,OTT,0,0,2,0,0,2
2009,20140,EDM,0,1,0,0,0,1
2009,20140,NSH,1,1,1,0,0,3
2009,20141,MTL,1,1,0,0,0,2
2009,20141,MIN,1,0,0,0,0,1
2009,20142,CAR,0,0,1,0,0,1
2009,20142,STL,0,0,0,0,0,0
2009,20143,COL,0,1,1,0,0,2
2009,20143,CBJ,1,3,0,0,0,4
2009,20144,BOS,1,0,1,0,0,2
2009,20144,CGY,0,2,1,0,0,3
2009,20145,PHX,0,2,2,0,0,4
2009,20145,PIT,0,1,0,0,0,1
2009,20146,LAK,0,0,0,0,0,0
2009,20146,VAN,2,1,1,0,0,4
2009,20147,DET,0,1,1,0,0,2
2009,20147,SJS,0,3,1,0,0,4
2009,20148,CHI,2,1,2,0,0,5
2009,20148,DAL,1,1,0,0,0,2
2009,20149,ANA,2,3,1,0,0,6
2009,20149,VAN,1,4,1,0,1,7
2009,20150,CAR,1,0,0,0,0,1
2009,20150,EDM,0,1,2,0,0,3
2009,20151,BOS,1,1,3,0,0,5
2009,20151,DAL,1,0,0,0,0,1
2009,20152,BUF,3,1,1,0,0,5
2009,20152,WSH,0,0,0,0,0,0
2009,20153,NYR,1,1,0,0,0,2
2009,20153,TOR,0,0,5,0,0,5
2009,20154,ATL,0,0,1,0,0,1
2009,20154,NJD,1,5,0,0,0,6
2009,20155,MTL,1,0,4,0,0,5
2009,20155,NYI,2,2,0,0,0,4
2009,20156,CHI,1,1,1,0,1,4
2009,20156,CBJ,1,0,2,0,0,3
2009,20157,OTT,0,2,0,0,0,2
2009,20157,TBL,0,1,1,0,1,3
2009,20158,FLA,1,1,0,0,0,2
2009,20158,NSH,1,0,1,0,1,3
2009,20159,PIT,1,3,2,0,0,6
2009,20159,STL,2,0,1,0,0,3
2009,20160,MIN,0,2,1,0,0,3
2009,20160,PHX,1,1,0,0,0,2
2009,20161,CGY,1,1,1,0,0,3
2009,20161,LAK,0,1,1,0,0,2
2009,20162,EDM,2,3,0,0,0,5
2009,20162,PHI,1,2,1,0,0,4
2009,20163,CAR,0,4,2,0,0,6
2009,20163,TOR,1,2,1,0,0,4
2009,20164,ATL,1,3,1,0,0,5
2009,20164,FLA,0,2,1,0,0,3
2009,20165,COL,1,0,2,0,0,3
2009,20165,SJS,2,1,2,0,0,5
2009,20166,ANA,1,2,0,0,0,3
2009,20166,CGY,0,1,1,0,0,2
2009,20167,DET,1,2,0,0,0,3
2009,20167,VAN,0,1,1,0,0,2
2009,20168,BUF,1,0,1,0,0,2
2009,20168,NJD,0,0,0,0,0,0
2009,20169,CBJ,0,0,3,0,0,3
2009,20169,NYI,0,3,0,1,0,4
2009,20170,CHI,0,2,4,0,0,6
2009,20170,COL,1,0,1,0,0,2
2009,20171,NYI,0,0,2,0,0,2
2009,20171,NYR,0,0,1,0,0,1
2009,20172,CAR,4,0,0,1,0,5
2009,20172,TOR,1,2,1,0,0,4
2009,20173,OTT,0,1,0,1,0,2
2009,20173,WSH,0,1,0,0,0,1
2009,20174,CGY,2,0,0,0,0,2
2009,20174,PHX,2,2,0,0,0,4
2009,20175,NSH,0,0,0,0,0,0
2009,20175,VAN,0,1,3,0,0,4
2009,20176,ANA,0,0,0,1,0,1
2009,20176,LAK,0,0,0,0,0,0
2009,20177,MIN,1,0,0,0,0,1
2009,20177,SJS,1,0,2,0,0,3
2009,20178,NJD,0,2,1,0,1,4
2009,20178,TBL,1,0,2,0,0,3
2009,20179,CBJ,1,1,3,0,0,5
2009,20179,EDM,0,2,2,0,0,4
2009,20180,ANA,1,3,1,0,0,5
2009,20180,STL,1,1,0,0,0,2
2009,20181,BOS,2,1,2,0,0,5
2009,20181,TOR,0,0,2,0,0,2
2009,20182,NYR,1,1,3,0,0,5
2009,20182,TBL,0,1,1,0,0,2
2009,20183,CAR,1,1,0,0,0,2
2009,20183,WSH,0,1,2,0,0,3
2009,20184,ATL,1,0,3,0,0,4
2009,20184,NYI,1,2,0,0,0,3
2009,20185,OTT,2,1,1,0,0,4
2009,20185,PHI,0,1,0,0,0,1
2009,20186,EDM,0,1,3,0,0,4
2009,20186,PIT,2,3,0,0,0,5
2009,20187,COL,0,1,0,0,0,1
2009,20187,MIN,2,1,0,0,0,3
2009,20188,CGY,4,2,1,0,0,7
2009,20188,NSH,0,3,3,0,0,6
2009,20189,PHX,0,0,0,0,0,0
2009,20189,VAN,1,0,0,0,0,1
2009,20190,FLA,0,0,2,0,0,2
2009,20190,LAK,2,0,1,0,0,3
2009,20191,SJS,1,1,2,0,1,5
2009,20191,STL,2,0,2,0,0,4
2009,20192,CAR,0,0,2,0,0,2
2009,20192,OTT,0,1,0,0,0,1
2009,20193,MTL,1,0,2,0,0,3
2009,20193,CBJ,1,0,2,0,1,4
2009,20194,ATL,1,2,1,1,0,5
2009,20194,BUF,2,2,0,0,0,4
2009,20195,ANA,1,0,1,0,0,2
2009,20195,DAL,2,2,1,0,0,5
2009,20196,BOS,1,2,0,0,0,3
2009,20196,BUF,1,0,0,0,0,1
2009,20197,MTL,0,3,0,0,0,3
2009,20197,TOR,1,3,2,0,0,6
2009,20198,NYI,1,2,0,0,0,3
2009,20198,PIT,0,2,1,0,1,4
2009,20199,PHI,1,0,0,0,0,1
2009,20199,TBL,0,2,0,0,0,2
2009,20200,NYR,0,0,1,0,0,1
2009,20200,WSH,2,0,1,0,0,3
2009,20201,DET,1,1,1,0,0,3
2009,20201,NJD,0,1,0,0,0,1
2009,20202,CGY,0,1,0,0,0,1
2009,20202,CBJ,1,1,1,0,0,3
2009,20203,COL,0,1,0,0,0,1
2009,20203,NSH,0,0,0,0,0,0
2009,20204,FLA,1,0,0,0,0,1
2009,20204,PHX,0,2,2,0,0,4
2009,20205,MIN,0,0,0,0,0,0
2009,20205,VAN,1,0,1,0,0,2
2009,20206,DAL,0,0,1,0,0,1
2009,20206,SJS,1,0,1,0,0,2
2009,20207,LAK,1,2,2,0,0,5
2009,20207,STL,0,0,3,0,0,3
2009,20208,ATL,0,4,1,0,0,5
2009,20208,CAR,0,2,0,0,0,2
2009,20209,EDM,0,2,0,0,0,2
2009,20209,NJD,0,0,1,0,0,1
2009,20210,CGY,0,1,0,0,0,1
2009,20210,CHI,2,1,3,0,0,6
2009,20211,PHX,2,1,1,0,0,4
2009,20211,SJS,2,0,0,0,0,2
2009,20212,ANA,1,0,0,0,0,1
2009,20212,FLA,1,2,0,0,0,3
2009,20213,EDM,1,1,0,0,1,3
2009,20213,NYR,0,1,1,0,0,2
2009,20214,TBL,0,1,1,0,0,2
2009,20214,WSH,3,0,1,0,0,4
2009,20215,NYI,0,0,1,0,0,1
2009,20215,PHI,0,1,2,0,0,3
2009,20216,DET,2,2,2,0,0,6
2009,20216,PIT,1,1,4,1,0,7
2009,20217,MTL,1,2,1,0,0,4
2009,20217,OTT,0,0,0,0,0,0
2009,20218,CGY,2,1,1,0,0,4
2009,20218,TOR,1,0,2,0,0,3
2009,20219,DAL,1,1,0,0,0,2
2009,20219,LAK,2,0,0,0,1,3
2009,20220,NSH,0,1,2,1,0,4
2009,20220,SJS,1,1,1,0,0,3
2009,20221,BUF,3,0,1,0,0,4
2009,20221,STL,1,1,1,0,0,3
2009,20222,NJD,1,0,1,0,0,2
2009,20222,NYR,0,4,1,0,0,5
2009,20223,CAR,1,0,0,0,0,1
2009,20223,WSH,3,1,1,0,0,5
2009,20224,CBJ,0,0,2,0,0,2
2009,20224,PHX,1,1,3,0,0,5
2009,20225,FLA,1,2,1,0,0,4
2009,20225,TBL,0,0,0,0,0,0
2009,20226,BOS,0,1,0,0,1,2
2009,20226,CHI,0,0,1,0,0,1
2009,20227,COL,0,0,1,0,1,2
2009,20227,VAN,0,1,0,0,0,1
2009,20228,BOS,3,1,2,0,0,6
2009,20228,MTL,0,1,0,0,0,1
2009,20229,NYI,1,1,1,0,0,3
2009,20229,OTT,1,0,0,0,0,1
2009,20230,PHI,0,4,0,0,0,4
2009,20230,PIT,1,2,1,0,1,5
2009,20231,DET,0,1,3,0,0,4
2009,20231,TBL,2,0,1,0,0,3
2009,20232,MIN,0,2,2,0,0,4
2009,20232,PHX,0,0,0,0,0,0
2009,20233,DAL,1,1,0,0,0,2
2009,20233,LAK,2,1,0,0,0,3
2009,20234,EDM,1,1,0,0,0,2
2009,20234,TOR,0,3,2,0,0,5
2009,20235,CGY,0,0,1,0,0,1
2009,20235,SJS,4,1,1,0,0,6
2009,20236,NJD,0,0,1,0,0,1
2009,20236,WSH,1,1,1,0,0,3
2009,20237,BUF,0,1,0,0,0,1
2009,20237,CBJ,3,1,2,0,0,6
2009,20238,ATL,1,1,1,0,0,3
2009,20238,CAR,0,1,1,0,0,2
2009,20239,DET,1,1,1,0,0,3
2009,20239,FLA,0,2,0,0,0,2
2009,20240,CHI,1,1,1,0,0,3
2009,20240,STL,3,0,0,1,0,4
2009,20241,ANA,2,0,1,0,0,3
2009,20241,NSH,2,0,1,1,0,4
2009,20242,MTL,0,0,1,0,0,1
2009,20242,PHI,0,2,0,0,0,2
2009,20243,NJD,1,2,2,0,1,6
2009,20243,WSH,2,1,2,0,0,5
2009,20244,NYI,0,2,1,0,0,3
2009,20244,OTT,0,0,2,0,0,2
2009,20245,BOS,0,2,0,0,0,2
2009,20245,NYR,0,0,2,0,1,3
2009,20246,TOR,0,0,2,0,0,2
2009,20246,VAN,2,2,0,0,0,4
2009,20247,BUF,1,1,0,0,0,2
2009,20247,PIT,0,1,4,0,0,5
2009,20248,CBJ,1,0,1,0,0,2
2009,20248,MIN,1,0,1,0,1,3
2009,20249,DAL,1,2,0,0,0,3
2009,20249,PHX,0,2,0,0,0,2
2009,20250,COL,1,0,1,0,1,3
2009,20250,EDM,1,1,0,0,0,2
2009,20251,LAK,0,1,0,0,0,1
2009,20251,NSH,0,1,2,0,0,3
2009,20252,CAR,0,2,0,0,1,3
2009,20252,TBL,1,1,0,0,0,2
2009,20253,MTL,0,1,1,0,1,3
2009,20253,STL,1,0,1,0,0,2
2009,20254,ATL,0,1,2,0,0,3
2009,20254,PHI,2,1,1,0,0,4
2009,20255,CHI,2,3,0,0,0,5
2009,20255,SJS,2,2,2,0,0,6
2009,20256,ANA,0,1,1,0,0,2
2009,20256,LAK,0,0,0,0,0,0
2009,20257,NYI,0,1,0,0,1,2
2009,20257,VAN,1,0,0,0,0,1
2009,20258,NYR,0,0,1,0,1,2
2009,20258,OTT,0,1,0,0,0,1
2009,20259,CAR,0,0,0,0,0,0
2009,20259,TBL,0,0,0,0,0,0
2009,20260,DET,1,2,1,0,0,4
2009,20260,EDM,0,0,0,0,0,0
2009,20261,NSH,0,0,1,0,0,1
2009,20261,SJS,2,2,0,0,0,4
2009,20262,MIN,1,0,0,0,1,2
2009,20262,PIT,1,0,0,0,0,1
2009,20263,MTL,0,1,0,0,0,1
2009,20263,CAR,0,0,2,0,0,2
2009,20264,CBJ,0,1,1,0,0,2
2009,20264,EDM,2,1,4,0,0,7
2009,20265,FLA,2,1,0,0,1,4
2009,20265,TBL,0,1,2,0,0,3
2009,20266,CHI,2,0,0,0,1,3
2009,20266,PHX,0,1,1,0,0,2
2009,20267,CGY,0,1,3,0,0,4
2009,20267,COL,1,0,0,0,0,1
2009,20268,BOS,3,3,1,0,0,7
2009,20268,BUF,4,0,0,0,0,4
2009,20269,NYR,0,2,1,0,0,3
2009,20269,VAN,2,3,1,0,0,6
2009,20270,ANA,2,0,2,0,0,4
2009,20270,WSH,3,2,1,0,0,6
2009,20271,FLA,0,0,1,0,0,1
2009,20271,NJD,0,1,2,0,0,3
2009,20272,ATL,1,1,0,0,0,2
2009,20272,PIT,1,1,1,0,0,3
2009,20273,MTL,1,0,1,0,1,3
2009,20273,OTT,1,0,1,0,0,2
2009,20274,MIN,0,2,0,0,0,2
2009,20274,VAN,0,2,1,0,0,3
2009,20275,CHI,1,3,2,0,0,6
2009,20275,DAL,1,2,0,0,0,3
2009,20276,CGY,0,1,0,0,0,1
2009,20276,COL,0,0,0,0,0,0
2009,20277,DET,3,1,0,0,0,4
2009,20277,EDM,0,1,2,0,0,3
2009,20278,LAK,1,1,3,0,0,5
2009,20278,WSH,0,1,1,0,0,2
2009,20279,BOS,2,2,0,0,0,4
2009,20279,FLA,1,0,1,0,0,2
2009,20280,NJD,2,2,1,0,0,5
2009,20280,NYI,0,2,0,0,0,2
2009,20281,CAR,1,2,2,0,0,5
2009,20281,PHX,2,0,0,0,0,2
2009,20282,BUF,0,0,0,0,0,0
2009,20282,PHI,1,0,2,0,0,3
2009,20283,NSH,1,0,0,0,0,1
2009,20283,TBL,3,1,0,0,0,4
2009,20284,ANA,0,0,2,0,0,2
2009,20284,STL,1,0,1,1,0,3
2009,20285,PIT,0,0,1,0,0,1
2009,20285,VAN,1,1,1,0,0,3
2009,20286,NYR,0,0,1,0,0,1
2009,20286,OTT,1,2,1,0,0,4
2009,20287,BUF,1,0,1,0,0,2
2009,20287,NYI,1,1,2,0,0,4
2009,20288,CHI,0,2,2,1,0,5
2009,20288,TOR,1,3,0,0,0,4
2009,20289,BOS,0,1,1,0,1,3
2009,20289,MTL,0,1,1,0,0,2
2009,20290,PHI,1,0,2,1,0,4
2009,20290,PHX,1,1,1,0,0,3
2009,20291,ATL,0,0,0,0,0,0
2009,20291,CBJ,1,0,1,0,0,2
2009,20292,MIN,0,1,0,0,0,1
2009,20292,STL,0,2,0,0,0,2
2009,20293,ANA,1,0,0,0,1,2
2009,20293,DAL,0,1,0,0,0,1
2009,20294,CGY,0,1,1,0,0,2
2009,20294,DET,1,1,3,0,0,5
2009,20295,COL,1,1,1,0,1,4
2009,20295,LAK,0,1,2,0,0,3
2009,20296,SJS,3,2,2,0,0,7
2009,20296,WSH,0,1,1,0,0,2
2009,20297,CAR,0,0,2,0,0,2
2009,20297,NSH,1,3,1,0,0,5
2009,20298,NJD,2,3,2,0,0,7
2009,20298,TBL,0,3,0,0,0,3
2009,20299,NYR,1,1,2,0,0,4
2009,20299,PHX,1,0,0,0,0,1
2009,20300,DAL,1,2,0,0,0,3
2009,20300,PHI,2,1,1,0,0,4
2009,20301,MTL,2,1,0,0,0,3
2009,20301,NYI,1,1,1,0,1,4
2009,20302,CAR,0,2,0,0,0,2
2009,20302,FLA,2,1,0,0,0,3
2009,20303,MIN,1,1,2,0,0,4
2009,20303,WSH,0,0,3,0,0,3
2009,20304,DET,1,0,1,0,0,2
2009,20304,VAN,0,1,1,1,0,3
2009,20305,ANA,2,1,1,0,0,4
2009,20305,COL,0,0,1,0,0,1
2009,20306,NSH,0,0,0,0,0,0
2009,20306,STL,0,0,0,0,1,1
2009,20307,ATL,1,3,2,0,0,6
2009,20307,TOR,0,1,2,0,0,3
2009,20308,CGY,2,2,2,0,0,6
2009,20308,LAK,0,0,2,0,0,2
2009,20309,BOS,0,1,1,0,0,2
2009,20309,BUF,2,1,0,0,0,3
2009,20310,NYI,2,1,0,0,0,3
2009,20310,PIT,0,1,4,0,0,5
2009,20311,ATL,1,1,1,0,0,3
2009,20311,WSH,3,1,1,0,0,5
2009,20312,CAR,0,1,0,0,0,1
2009,20312,PHI,1,0,2,0,0,3
2009,20313,CBJ,1,0,1,0,0,2
2009,20313,PHX,0,2,1,0,0,3
2009,20314,NYR,0,2,0,0,1,3
2009,20314,TBL,0,1,1,0,0,2
2009,20315,FLA,0,0,2,0,0,2
2009,20315,NJD,2,0,0,1,0,3
2009,20316,MTL,0,3,0,0,0,3
2009,20316,DET,0,0,1,0,0,1
2009,20317,DAL,1,1,2,0,0,4
2009,20317,MIN,2,1,0,0,0,3
2009,20318,COL,1,1,1,0,0,3
2009,20318,STL,0,1,0,0,0,1
2009,20319,EDM,1,0,0,0,0,1
2009,20319,LAK,1,1,0,0,0,2
2009,20320,CHI,0,1,1,0,0,2
2009,20320,SJS,1,0,1,1,0,3
2009,20321,OTT,1,0,0,0,1,2
2009,20321,TOR,1,0,0,0,0,1
2009,20322,CGY,1,1,2,0,0,4
2009,20322,VAN,2,0,1,0,0,3
2009,20323,BOS,0,2,5,0,0,7
2009,20323,NYI,1,0,1,0,0,2
2009,20324,CAR,0,2,0,1,0,3
2009,20324,PHI,1,1,0,0,0,2
2009,20325,MIN,1,0,3,0,0,4
2009,20325,TBL,1,1,0,0,0,2
2009,20326,COL,0,0,1,0,0,1
2009,20326,PHX,1,1,0,0,0,2
2009,20327,ANA,0,1,0,0,0,1
2009,20327,CHI,0,0,0,0,0,0
2009,20328,MTL,0,0,0,0,0,0
2009,20328,WSH,1,0,2,0,0,3
2009,20329,BUF,1,1,2,0,0,4
2009,20329,PIT,1,2,0,0,0,3
2009,20330,ATL,1,1,1,0,0,3
2009,20330,NSH,1,1,1,1,0,4
2009,20331,FLA,1,1,1,0,0,3
2009,20331,NYR,2,0,1,0,1,4
2009,20332,CBJ,1,1,1,0,0,3
2009,20332,DET,1,2,2,0,0,5
2009,20333,DAL,1,0,1,0,0,2
2009,20333,SJS,3,2,1,0,0,6
2009,20334,EDM,0,2,2,0,0,4
2009,20334,STL,2,0,0,0,0,2
2009,20335,CHI,2,0,0,0,0,2
2009,20335,LAK,1,1,3,0,0,5
2009,20336,BOS,2,1,1,0,0,4
2009,20336,DET,0,1,0,0,0,1
2009,20337,PHI,1,1,0,0,0,2
2009,20337,TOR,1,2,1,0,0,4
2009,20338,BUF,1,1,0,0,0,2
2009,20338,MTL,0,3,0,0,0,3
2009,20339,NYI,1,1,2,0,0,4
2009,20339,OTT,1,0,1,0,0,2
2009,20340,CBJ,1,1,1,0,0,3
2009,20340,WSH,0,0,0,0,0,0
2009,20341,NJD,0,0,1,0,0,1
2009,20341,PIT,1,2,1,0,0,4
2009,20342,MIN,2,2,2,0,0,6
2009,20342,NSH,0,1,1,0,0,2
2009,20343,COL,3,0,1,0,0,4
2009,20343,TBL,0,1,2,0,0,3
2009,20344,PHX,2,0,0,0,0,2
2009,20344,SJS,2,0,1,0,0,3
2009,20345,CGY,0,1,2,0,0,3
2009,20345,VAN,0,0,1,0,0,1
2009,20346,FLA,0,3,1,0,0,4
2009,20346,NYR,0,0,0,0,0,0
2009,20347,ATL,2,0,0,0,0,2
2009,20347,STL,1,1,2,0,0,4
2009,20348,DAL,2,0,2,0,0,4
2009,20348,EDM,0,1,2,0,0,3
2009,20349,ANA,1,0,3,0,0,4
2009,20349,CAR,1,0,0,0,0,1
2009,20350,BUF,0,0,0,0,0,0
2009,20350,NSH,0,0,2,0,0,2
2009,20351,CBJ,0,1,2,0,0,3
2009,20351,VAN,0,1,1,0,0,2
2009,20352,ANA,1,0,0,0,0,1
2009,20352,DET,0,1,1,0,0,2
2009,20353,COL,2,4,0,0,0,6
2009,20353,MIN,2,2,1,0,0,5
2009,20354,LAK,1,0,0,0,0,1
2009,20354,TOR,0,0,3,0,0,3
2009,20355,PHI,1,0,2,1,0,4
2009,20355,TBL,1,0,2,0,0,3
2009,20356,FLA,0,3,2,0,0,5
2009,20356,WSH,1,0,2,0,0,3
2009,20357,ATL,0,0,4,0,0,4
2009,20357,MTL,1,2,2,0,0,5
2009,20358,CGY,0,1,0,0,0,1
2009,20358,DAL,1,1,1,0,0,3
2009,20359,LAK,1,1,0,0,0,2
2009,20359,PHX,1,0,3,0,0,4
2009,20360,SJS,4,0,1,0,0,5
2009,20360,TOR,0,1,1,0,0,2
2009,20361,ATL,1,0,0,0,0,1
2009,20361,OTT,3,1,1,0,0,5
2009,20362,NYR,0,1,1,0,1,3
2009,20362,PIT,1,1,0,0,0,2
2009,20363,MIN,0,1,3,0,0,4
2009,20363,STL,0,0,0,0,0,0
2009,20364,ANA,0,1,1,0,0,2
2009,20364,CHI,1,0,3,0,0,4
2009,20365,DAL,0,0,2,0,0,2
2009,20365,EDM,2,1,2,0,0,5
2009,20366,MTL,3,1,2,0,0,6
2009,20366,NYR,0,2,0,0,0,2
2009,20367,NJD,0,1,1,1,0,3
2009,20367,PHI,0,1,1,0,0,2
2009,20368,NYI,1,1,0,0,0,2
2009,20368,WSH,2,0,3,0,0,5
2009,20369,CAR,0,2,0,0,0,2
2009,20369,PIT,2,3,0,0,0,5
2009,20370,BOS,0,1,2,0,0,3
2009,20370,TBL,1,0,0,0,0,1
2009,20371,BUF,0,0,1,0,0,1
2009,20371,FLA,0,2,0,0,0,2
2009,20372,DET,2,1,3,0,0,6
2009,20372,VAN,1,2,2,0,0,5
2009,20373,COL,2,0,0,0,0,2
2009,20373,NSH,3,0,0,0,0,3
2009,20374,PHX,2,1,3,0,0,6
2009,20374,TOR,2,1,0,0,0,3
2009,20375,CBJ,1,0,1,0,0,2
2009,20375,SJS,0,1,2,0,0,3
2009,20376,MIN,0,1,0,0,0,1
2009,20376,VAN,1,1,0,0,0,2
2009,20377,CGY,0,1,2,1,0,4
2009,20377,STL,2,1,0,0,0,3
2009,20378,COL,0,0,1,0,0,1
2009,20378,DAL,0,1,0,0,1,2
2009,20379,EDM,3,0,1,0,1,5
2009,20379,LAK,0,4,0,0,0,4
2009,20380,TOR,0,0,1,0,0,1
2009,20380,WSH,0,1,1,0,0,2
2009,20381,MTL,1,0,0,0,0,1
2009,20381,NJD,0,1,0,1,0,2
2009,20382,OTT,0,3,0,0,0,3
2009,20382,PIT,0,1,1,0,0,2
2009,20383,ATL,1,2,2,0,0,5
2009,20383,NYI,1,0,0,0,0,1
2009,20384,CAR,0,0,1,0,0,1
2009,20384,PHI,1,0,0,1,0,2
2009,20385,BOS,1,1,2,0,0,4
2009,20385,FLA,0,0,0,0,0,0
2009,20386,CHI,3,1,0,0,0,4
2009,20386,DET,2,0,2,0,1,5
2009,20387,BUF,1,2,1,0,0,4
2009,20387,TBL,1,2,0,0,0,3
2009,20388,MIN,0,0,0,0,0,0
2009,20388,NSH,0,0,1,0,0,1
2009,20389,PHX,1,2,0,0,0,3
2009,20389,STL,1,3,0,0,0,4
2009,20390,EDM,1,1,0,1,0,3
2009,20390,SJS,1,1,0,0,0,2
2009,20391,CBJ,0,0,0,0,0,0
2009,20391,LAK,0,2,1,0,0,3
2009,20392,CAR,1,0,2,0,0,3
2009,20392,WSH,0,0,1,0,0,1
2009,20393,CGY,0,1,2,0,0,3
2009,20393,NYR,0,0,0,0,0,0
2009,20394,CHI,4,3,0,0,0,7
2009,20394,PHX,0,1,0,0,0,1
2009,20395,COL,0,2,2,0,1,5
2009,20395,VAN,1,2,1,0,0,4
2009,20396,ANA,0,3,2,0,0,5
2009,20396,CBJ,0,1,2,0,0,3
2009,20397,BOS,3,1,1,0,0,5
2009,20397,TBL,0,1,2,0,0,3
2009,20398,NYI,1,1,0,0,0,2
2009,20398,TOR,1,2,1,0,0,4
2009,20399,FLA,1,2,0,1,0,4
2009,20399,OTT,1,2,0,0,0,3
2009,20400,BUF,1,2,1,0,0,4
2009,20400,PIT,2,1,0,0,0,3
2009,20401,NSH,1,2,0,0,0,3
2009,20401,STL,1,2,3,0,0,6
2009,20402,NYI,2,0,1,0,0,3
2009,20402,PHI,1,2,1,0,0,4
2009,20403,CGY,0,1,0,0,0,1
2009,20403,MTL,1,2,1,0,0,4
2009,20404,NSH,1,0,0,0,0,1
2009,20404,VAN,1,0,2,0,0,3
2009,20405,BUF,1,2,1,0,0,4
2009,20405,TBL,2,0,0,0,0,2
2009,20406,NJD,0,1,3,0,0,4
2009,20406,PIT,0,0,1,0,0,1
2009,20407,BOS,0,1,0,0,0,1
2009,20407,WSH,1,1,1,0,0,3
2009,20408,ATL,0,1,1,0,0,2
2009,20408,NYR,0,1,1,1,0,3
2009,20409,CGY,0,0,0,0,0,0
2009,20409,DET,0,0,0,0,0,0
2009,20410,CHI,1,0,1,0,0,2
2009,20410,OTT,0,0,0,0,0,0
2009,20411,DAL,2,1,0,0,0,3
2009,20411,PHX,2,1,2,0,0,5
2009,20412,COL,3,3,0,0,0,6
2009,20412,LAK,0,1,0,0,0,1
2009,20413,ANA,1,1,2,0,0,4
2009,20413,STL,1,0,1,0,0,2
2009,20414,CAR,1,4,0,0,0,5
2009,20414,PHI,0,1,4,0,1,6
2009,20415,CBJ,0,0,1,0,1,2
2009,20415,NSH,0,0,1,0,0,1
2009,20416,MTL,1,0,0,0,0,1
2009,20416,TBL,2,1,0,0,0,3
2009,20417,NYI,1,0,1,0,0,2
2009,20417,PIT,4,4,1,0,0,9
2009,20418,EDM,0,0,0,0,0,0
2009,20418,FLA,0,1,1,0,0,2
2009,20419,MIN,0,0,1,0,0,1
2009,20419,PHX,0,2,1,0,0,3
2009,20420,LAK,1,3,2,0,0,6
2009,20420,STL,0,1,1,0,0,2
2009,20421,ANA,0,0,0,0,0,0
2009,20421,SJS,1,1,0,0,0,2
2009,20422,NJD,2,3,3,0,0,8
2009,20422,NYR,1,2,2,0,0,5
2009,20423,OTT,0,0,1,0,0,1
2009,20423,WSH,1,2,2,0,0,5
2009,20424,BUF,1,0,0,0,0,1
2009,20424,TOR,0,1,1,0,0,2
2009,20425,ATL,1,0,2,0,0,3
2009,20425,BOS,4,0,3,0,0,7
2009,20426,DAL,0,2,1,0,0,3
2009,20426,DET,1,0,0,0,0,1
2009,20427,CHI,1,1,2,0,0,4
2009,20427,COL,2,0,1,0,0,3
2009,20428,CGY,1,1,0,0,0,2
2009,20428,FLA,1,1,0,0,1,3
2009,20429,PHI,2,3,1,0,0,6
2009,20429,PIT,0,1,2,0,0,3
2009,20430,LAK,1,0,2,0,0,3
2009,20430,MIN,0,0,1,0,0,1
2009,20431,ATL,1,0,1,0,0,2
2009,20431,BOS,2,1,1,0,0,4
2009,20432,MTL,0,1,0,0,0,1
2009,20432,WSH,1,0,1,0,0,2
2009,20433,OTT,0,1,1,0,0,2
2009,20433,TBL,0,0,0,0,0,0
2009,20434,BUF,1,1,2,0,0,4
2009,20434,NJD,0,2,0,0,0,2
2009,20435,CAR,1,1,0,0,0,2
2009,20435,NYR,2,0,0,0,1,3
2009,20436,CBJ,0,2,1,0,0,3
2009,20436,NYI,0,1,0,0,0,1
2009,20437,DAL,0,0,0,0,0,0
2009,20437,NSH,1,0,2,0,0,3
2009,20438,DET,1,2,1,0,1,5
2009,20438,PHX,1,1,2,0,0,4
2009,20439,EDM,1,1,1,0,0,3
2009,20439,VAN,0,0,0,0,0,0
2009,20440,SJS,1,1,3,0,0,5
2009,20440,STL,1,2,1,0,0,4
2009,20441,CHI,0,1,2,0,0,3
2009,20441,CBJ,1,0,0,0,0,1
2009,20442,ANA,2,2,0,0,0,4
2009,20442,MIN,1,1,0,0,0,2
2009,20443,FLA,2,0,1,0,0,3
2009,20443,VAN,1,4,0,0,0,5
2009,20444,COL,2,0,1,0,0,3
2009,20444,DET,0,1,1,0,0,2
2009,20445,LAK,2,0,0,0,0,2
2009,20445,SJS,1,1,0,0,1,3
2009,20446,NYI,1,1,2,0,0,4
2009,20446,WSH,2,2,0,1,0,5
2009,20447,COL,1,1,0,0,0,2
2009,20447,PHI,2,2,1,0,0,5
2009,20448,MTL,0,2,0,0,0,2
2009,20448,CAR,2,1,0,0,0,3
2009,20449,NJD,1,1,0,0,0,2
2009,20449,TOR,0,2,0,0,1,3
2009,20450,ATL,1,0,3,0,0,4
2009,20450,OTT,0,0,1,0,0,1
2009,20451,CGY,2,3,1,0,0,6
2009,20451,STL,0,2,1,0,0,3
2009,20452,DAL,1,0,0,1,0,2
2009,20452,PHX,0,0,1,0,0,1
2009,20453,CHI,2,5,2,0,0,9
2009,20453,EDM,0,1,1,0,0,2
2009,20454,ANA,0,1,0,0,0,1
2009,20454,NYR,0,1,2,0,0,3
2009,20455,BUF,1,1,1,0,0,3
2009,20455,NJD,2,1,2,0,0,5
2009,20456,CBJ,0,0,1,1,0,2
2009,20456,SJS,0,0,1,0,0,1
2009,20457,CGY,0,2,0,1,0,3
2009,20457,MIN,0,1,1,0,0,2
2009,20458,EDM,0,0,2,0,0,2
2009,20458,VAN,0,3,1,0,0,4
2009,20459,LAK,1,0,1,0,0,2
2009,20459,NYR,1,1,0,1,0,3
2009,20460,BOS,2,4,2,0,0,8
2009,20460,TOR,1,4,0,0,0,5
2009,20461,STL,0,1,1,0,0,2
2009,20461,WSH,1,2,1,0,0,4
2009,20462,CAR,1,0,0,1,0,2
2009,20462,FLA,0,0,1,0,0,1
2009,20463,ATL,1,1,1,0,0,3
2009,20463,PIT,2,3,1,0,0,6
2009,20464,MTL,3,1,1,0,0,5
2009,20464,PHI,1,0,1,0,0,2
2009,20465,COL,1,0,0,0,1,2
2009,20465,TBL,0,1,0,0,0,1
2009,20466,DET,2,1,3,0,0,6
2009,20466,SJS,0,0,0,0,0,0
2009,20467,CBJ,2,2,1,0,0,5
2009,20467,DAL,2,3,0,0,1,6
2009,20468,NSH,0,1,0,0,0,1
2009,20468,PHX,1,0,1,0,0,2
2009,20469,NJD,2,1,2,0,0,5
2009,20469,OTT,0,1,0,0,0,1
2009,20470,BUF,1,2,2,0,0,5
2009,20470,LAK,0,0,0,0,0,0
2009,20471,MIN,0,1,3,0,0,4
2009,20471,NYI,0,1,0,0,0,1
2009,20472,CGY,1,1,0,0,0,2
2009,20472,CHI,0,2,0,1,0,3
2009,20473,ANA,1,1,0,0,1,3
2009,20473,EDM,0,0,2,0,0,2
2009,20474,BOS,0,1,3,0,0,4
2009,20474,CAR,1,0,1,0,0,2
2009,20475,PHI,1,2,4,0,0,7
2009,20475,WSH,0,0,1,0,0,1
2009,20476,BUF,1,1,1,0,0,3
2009,20476,MTL,0,1,2,1,0,4
2009,20477,DAL,1,2,1,0,0,4
2009,20477,OTT,1,2,1,1,0,5
2009,20478,PIT,1,0,2,0,0,3
2009,20478,TOR,3,2,2,0,0,7
2009,20479,ATL,3,0,1,0,0,4
2009,20479,TBL,2,0,1,0,0,3
2009,20480,DET,2,1,3,0,0,6
2009,20480,LAK,2,1,1,0,0,4
2009,20481,NSH,1,0,0,0,0,1
2009,20481,NYI,0,0,0,0,0,0
2009,20482,MIN,1,0,1,0,0,2
2009,20482,STL,2,0,2,0,0,4
2009,20483,CBJ,0,0,0,0,0,0
2009,20483,PHX,0,1,1,0,0,2
2009,20484,CHI,0,2,1,0,0,3
2009,20484,VAN,1,0,0,0,0,1
2009,20485,NYR,1,1,0,0,0,2
2009,20485,SJS,2,1,0,0,0,3
2009,20486,COL,0,0,0,0,0,0
2009,20486,FLA,0,2,1,0,0,3
2009,20487,BOS,3,2,1,0,0,6
2009,20487,STL,2,1,0,0,0,3
2009,20488,MTL,0,1,1,0,0,2
2009,20488,CAR,1,1,0,1,0,3
2009,20489,NJD,0,2,0,0,1,3
2009,20489,PHI,0,1,1,0,0,2
2009,20490,BUF,1,2,0,0,0,3
2009,20490,PIT,0,2,1,1,0,4
2009,20491,ATL,0,1,1,0,0,2
2009,20491,TOR,2,1,3,0,0,6
2009,20492,EDM,2,0,2,0,0,4
2009,20492,PHX,0,2,0,0,0,2
2009,20493,ANA,1,0,2,0,0,3
2009,20493,VAN,2,1,1,0,0,4
2009,20494,BOS,0,0,2,0,0,2
2009,20494,NJD,0,0,0,0,0,0
2009,20495,ATL,1,1,2,0,0,4
2009,20495,NYI,0,1,1,0,0,2
2009,20496,NYR,3,1,0,0,0,4
2009,20496,WSH,0,1,3,1,0,5
2009,20497,OTT,1,1,2,0,0,4
2009,20497,PHI,2,2,2,0,0,6
2009,20498,CBJ,0,0,0,0,0,0
2009,20498,LAK,2,0,1,0,0,3
2009,20499,DAL,4,3,1,0,0,8
2009,20499,TOR,0,1,1,0,0,2
2009,20500,PIT,0,0,0,0,0,0
2009,20500,TBL,0,1,1,0,0,2
2009,20501,FLA,0,1,2,0,0,3
2009,20501,NSH,0,0,0,0,0,0
2009,20502,DET,2,2,0,0,0,4
2009,20502,STL,0,0,1,0,0,1
2009,20503,CAR,1,1,0,0,0,2
2009,20503,MIN,0,3,0,0,0,3
2009,20504,COL,1,1,2,1,0,5
2009,20504,PHX,1,0,3,0,0,4
2009,20505,ANA,0,1,2,0,0,3
2009,20505,CGY,0,1,3,0,0,4
2009,20506,SJS,3,2,0,0,0,5
2009,20506,VAN,0,0,0,0,0,0
2009,20507,NJD,0,0,0,0,0,0
2009,20507,PIT,0,1,0,0,0,1
2009,20508,NYI,1,1,2,0,0,4
2009,20508,TOR,1,0,0,0,0,1
2009,20509,BUF,0,0,2,0,0,2
2009,20509,WSH,0,1,2,0,0,3
2009,20510,ATL,1,2,1,0,0,4
2009,20510,CAR,1,1,3,0,0,5
2009,20511,FLA,1,0,2,0,0,3
2009,20511,TBL,1,2,0,0,1,4
2009,20512,DET,1,0,1,0,0,2
2009,20512,NSH,1,2,0,0,0,3
2009,20513,CHI,2,0,3,0,0,5
2009,20513,PHI,1,0,0,0,0,1
2009,20514,EDM,0,3,0,0,0,3
2009,20514,VAN,0,1,1,0,0,2
2009,20515,LAK,0,0,1,0,0,1
2009,20515,PHX,1,1,0,0,0,2
2009,20516,BUF,1,1,1,0,1,4
2009,20516,NYI,0,1,2,0,0,3
2009,20517,MTL,2,0,1,0,0,3
2009,20517,PIT,1,1,0,0,0,2
2009,20518,BOS,0,2,2,0,0,4
2009,20518,CAR,1,1,0,0,0,2
2009,20519,CBJ,2,1,0,0,0,3
2009,20519,PHI,0,0,0,0,0,0
2009,20520,NJD,2,1,1,0,0,4
2009,20520,NYR,1,0,1,0,0,2
2009,20521,FLA,0,3,1,0,0,4
2009,20521,TBL,2,2,2,0,0,6
2009,20522,ANA,1,0,2,0,0,3
2009,20522,DAL,0,1,2,1,0,4
2009,20523,SJS,0,2,0,0,0,2
2009,20523,STL,1,0,1,0,1,3
2009,20524,COL,3,0,0,0,1,4
2009,20524,DET,0,3,0,0,0,3
2009,20525,LAK,3,1,0,0,0,4
2009,20525,PHX,0,0,0,0,0,0
2009,20526,CGY,0,3,3,0,0,6
2009,20526,OTT,0,2,1,0,0,3
2009,20527,ATL,1,0,0,0,0,1
2009,20527,BOS,0,1,1,0,0,2
2009,20528,ANA,1,1,2,0,0,4
2009,20528,STL,1,1,1,0,0,3
2009,20529,CHI,2,1,1,0,0,4
2009,20529,MIN,0,0,1,0,0,1
2009,20530,TOR,1,0,0,0,0,1
2009,20530,WSH,0,2,2,0,0,4
2009,20531,EDM,2,3,0,0,0,5
2009,20531,NSH,2,0,0,0,0,2
2009,20532,OTT,0,0,0,0,0,0
2009,20532,VAN,1,2,0,0,0,3
2009,20533,NYI,1,1,2,0,0,4
2009,20533,NYR,0,1,4,0,0,5
2009,20534,MTL,1,2,2,0,0,5
2009,20534,FLA,1,1,0,0,0,2
2009,20535,DAL,0,0,1,0,0,1
2009,20535,SJS,1,0,2,0,0,3
2009,20536,COL,2,2,1,0,0,5
2009,20536,NSH,0,1,0,0,0,1
2009,20537,CGY,1,0,1,0,0,2
2009,20537,MIN,0,1,0,0,0,1
2009,20538,CBJ,0,1,1,0,0,2
2009,20538,LAK,0,0,0,0,0,0
2009,20539,BUF,0,0,2,0,0,2
2009,20539,WSH,2,1,1,0,0,4
2009,20540,ATL,2,0,1,0,0,3
2009,20540,TOR,1,2,0,1,0,4
2009,20541,BOS,0,3,2,0,0,5
2009,20541,PIT,1,1,0,0,0,2
2009,20542,MTL,0,0,1,0,1,2
2009,20542,TBL,1,0,0,0,0,1
2009,20543,CHI,0,0,0,0,0,0
2009,20543,DET,1,1,2,0,0,4
2009,20544,NJD,1,1,2,0,0,4
2009,20544,STL,2,0,1,0,0,3
2009,20545,EDM,1,1,0,0,0,2
2009,20545,OTT,1,1,1,0,0,3
2009,20546,PHI,2,1,0,0,0,3
2009,20546,VAN,1,1,0,0,0,2
2009,20547,FLA,1,0,1,0,0,2
2009,20547,NYI,0,3,1,0,0,4
2009,20548,MIN,1,0,1,1,0,3
2009,20548,SJS,0,1,1,0,0,2
2009,20549,ATL,1,0,0,0,0,1
2009,20549,CAR,1,1,1,0,0,3
2009,20550,COL,1,0,0,0,0,1
2009,20550,PHX,0,2,1,0,0,3
2009,20551,DAL,1,2,1,0,0,4
2009,20551,NJD,2,0,0,0,0,2
2009,20552,ANA,0,0,0,0,0,0
2009,20552,CBJ,0,0,2,0,0,2
2009,20553,CGY,2,1,3,0,0,6
2009,20553,EDM,2,1,1,0,0,4
2009,20554,CHI,3,0,1,0,0,4
2009,20554,DET,1,3,2,0,0,6
2009,20555,BOS,2,1,1,0,0,4
2009,20555,PIT,1,0,1,0,0,2
2009,20556,BUF,0,3,1,0,0,4
2009,20556,TOR,0,0,1,0,0,1
2009,20557,TBL,0,3,1,0,0,4
2009,20557,WSH,3,1,3,0,0,7
2009,20558,NSH,0,1,0,0,0,1
2009,20558,VAN,1,0,1,0,0,2
2009,20559,MTL,1,0,0,0,0,1
2009,20559,NJD,2,1,1,0,0,4
2009,20560,CAR,1,0,1,0,0,2
2009,20560,STL,0,0,1,0,0,1
2009,20561,ATL,1,1,1,0,1,4
2009,20561,VAN,1,1,1,0,0,3
2009,20562,COL,1,0,0,0,0,1
2009,20562,CBJ,0,3,3,0,0,6
2009,20563,NYI,1,0,3,0,0,4
2009,20563,PHX,2,1,2,0,0,5
2009,20564,ANA,1,3,0,0,0,4
2009,20564,PHI,1,3,0,0,1,5
2009,20565,BOS,1,1,0,0,0,2
2009,20565,BUF,2,2,0,0,0,4
2009,20566,FLA,2,3,1,0,0,6
2009,20566,PIT,0,1,0,0,0,1
2009,20567,CGY,1,0,2,0,0,3
2009,20567,NSH,1,1,0,0,0,2
2009,20568,OTT,1,0,0,0,0,1
2009,20568,TOR,0,1,2,0,0,3
2009,20569,NYR,0,1,0,0,0,1
2009,20569,WSH,0,2,0,0,0,2
2009,20570,CAR,2,1,0,0,0,3
2009,20570,TBL,2,0,0,0,0,2
2009,20571,DET,1,0,1,0,1,3
2009,20571,MIN,0,0,2,0,0,2
2009,20572,CBJ,2,0,0,0,0,2
2009,20572,STL,2,1,2,0,0,5
2009,20573,DAL,0,1,0,0,0,1
2009,20573,EDM,2,1,1,0,0,4
2009,20574,LAK,0,1,0,0,1,2
2009,20574,PHI,0,1,0,0,0,1
2009,20575,NYI,0,1,2,0,0,3
2009,20575,SJS,2,1,2,0,0,5
2009,20576,MTL,0,4,1,0,1,6
2009,20576,FLA,2,0,3,0,0,5
2009,20577,ATL,0,0,1,0,0,1
2009,20577,TBL,1,1,2,0,0,4
2009,20578,NJD,1,1,1,1,0,4
2009,20578,OTT,1,1,1,0,0,3
2009,20579,CGY,0,1,1,0,0,2
2009,20579,CHI,1,3,1,0,0,5
2009,20580,COL,0,0,0,0,0,0
2009,20580,MIN,2,0,0,0,0,2
2009,20581,ANA,0,1,1,0,0,2
2009,20581,PHX,0,0,0,0,0,0
2009,20582,DAL,1,1,0,0,1,3
2009,20582,VAN,2,0,0,0,0,2
2009,20583,NYR,1,1,2,0,0,4
2009,20583,PIT,0,0,0,0,0,0
2009,20584,EDM,0,2,1,0,0,3
2009,20584,NYI,2,0,0,0,0,2
2009,20585,BOS,0,0,0,0,0,0
2009,20585,MIN,0,1,0,0,0,1
2009,20586,BUF,2,1,1,0,0,4
2009,20586,OTT,0,2,0,0,0,2
2009,20587,PHI,0,0,1,0,0,1
2009,20587,WSH,1,0,0,0,1,2
2009,20588,CAR,1,1,1,0,0,3
2009,20588,NJD,0,0,2,0,0,2
2009,20589,FLA,2,1,1,0,0,4
2009,20589,TOR,0,0,2,0,0,2
2009,20590,ATL,0,0,1,0,0,1
2009,20590,PIT,1,2,0,0,0,3
2009,20591,CBJ,0,0,0,0,0,0
2009,20591,DET,0,0,3,0,0,3
2009,20592,COL,1,1,0,0,0,2
2009,20592,NSH,1,0,0,0,0,1
2009,20593,CGY,3,1,1,0,0,5
2009,20593,SJS,0,2,0,0,0,2
2009,20594,CHI,4,1,1,0,0,6
2009,20594,PHX,0,0,0,0,0,0
2009,20595,ANA,1,0,2,0,0,3
2009,20595,LAK,0,1,0,0,0,1
2009,20596,MTL,2,0,4,0,0,6
2009,20596,NYR,1,1,1,0,0,3
2009,20597,EDM,0,1,1,0,0,2
2009,20597,VAN,0,3,1,0,0,4
2009,20598,BOS,2,1,3,0,0,6
2009,20598,OTT,1,2,1,0,0,4
2009,20599,ATL,0,3,1,0,0,4
2009,20599,NJD,0,0,0,0,0,0
2009,20600,MIN,1,0,0,0,0,1
2009,20600,PHI,0,1,2,0,0,3
2009,20601,MTL,3,2,1,0,0,6
2009,20601,TOR,1,0,1,0,0,2
2009,20602,CAR,1,0,1,0,0,2
2009,20602,FLA,1,0,3,0,0,4
2009,20603,DAL,0,0,1,0,0,1
2009,20603,DET,2,2,2,0,0,6
2009,20604,NSH,0,3,2,0,0,5
2009,20604,PIT,1,2,0,0,0,3
2009,20605,CHI,0,1,0,0,0,1
2009,20605,COL,1,0,1,0,0,2
2009,20606,CGY,1,2,2,0,0,5
2009,20606,NYI,0,2,0,0,0,2
2009,20607,PHX,1,1,1,0,0,3
2009,20607,TBL,1,1,0,0,0,2
2009,20608,ANA,0,1,2,0,0,3
2009,20608,LAK,1,2,1,0,0,4
2009,20609,CBJ,1,1,1,0,0,3
2009,20609,WSH,0,0,0,0,0,0
2009,20610,BUF,0,1,0,0,1,2
2009,20610,NYR,1,0,0,0,0,1
2009,20611,EDM,1,0,0,0,0,1
2009,20611,SJS,3,1,0,0,0,4
2009,20612,STL,1,2,3,0,0,6
2009,20612,VAN,2,0,2,0,0,4
2009,20613,ANA,0,3,0,0,0,3
2009,20613,TBL,1,2,1,0,0,4
2009,20614,BOS,2,3,0,0,0,5
2009,20614,CAR,0,0,1,0,0,1
2009,20615,COL,1,3,1,0,0,5
2009,20615,PIT,1,1,1,0,0,3
2009,20616,MTL,1,0,4,0,0,5
2009,20616,WSH,1,1,2,0,0,4
2009,20617,NYR,1,0,1,0,0,2
2009,20617,OTT,0,0,0,0,0,0
2009,20618,PHI,1,0,3,0,0,4
2009,20618,TOR,0,0,1,0,0,1
2009,20619,ATL,1,2,1,0,0,4
2009,20619,FLA,3,0,5,0,0,8
2009,20620,BUF,1,0,0,0,0,1
2009,20620,DET,0,1,2,0,0,3
2009,20621,CBJ,1,0,3,0,0,4
2009,20621,MIN,1,0,1,0,0,2
2009,20622,CHI,0,0,1,0,0,1
2009,20622,NSH,1,1,2,0,0,4
2009,20623,DAL,0,0,0,0,0,0
2009,20623,PHX,0,0,0,0,1,1
2009,20624,SJS,1,1,2,0,0,4
2009,20624,VAN,1,1,0,0,0,2
2009,20625,LAK,0,0,1,0,0,1
2009,20625,NJD,1,2,2,0,0,5
2009,20626,CHI,1,1,1,0,0,3
2009,20626,NSH,1,0,0,0,0,1
2009,20627,EDM,0,1,1,0,0,2
2009,20627,STL,0,1,0,0,0,1
2009,20628,ANA,2,0,2,0,0,4
2009,20628,NJD,1,1,1,0,0,3
2009,20629,DAL,1,2,1,1,0,5
2009,20629,DET,3,0,1,0,0,4
2009,20630,LAK,0,1,0,0,0,1
2009,20630,TBL,2,1,0,0,0,3
2009,20631,BOS,0,2,1,0,0,3
2009,20631,MTL,0,1,0,0,0,1
2009,20632,NYI,1,0,0,0,0,1
2009,20632,NYR,0,2,0,0,0,2
2009,20633,PHI,1,0,1,0,0,2
2009,20633,PIT,1,3,0,0,0,4
2009,20634,EDM,2,1,2,0,0,5
2009,20634,WSH,0,1,1,0,0,2
2009,20635,COL,1,0,2,0,0,3
2009,20635,CBJ,0,1,3,0,0,4
2009,20636,NSH,0,0,2,0,0,2
2009,20636,TOR,0,0,0,0,0,0
2009,20637,CAR,0,1,0,0,0,1
2009,20637,OTT,2,1,2,0,0,5
2009,20638,MIN,2,1,3,0,0,6
2009,20638,PHX,0,1,2,0,0,3
2009,20639,CGY,1,0,2,0,0,3
2009,20639,STL,1,0,0,0,0,1
2009,20640,NJD,3,0,2,0,0,5
2009,20640,VAN,0,1,2,0,0,3
2009,20641,SJS,2,3,2,0,0,7
2009,20641,TBL,0,1,0,0,0,1
2009,20642,PIT,1,1,1,0,0,3
2009,20642,WSH,0,2,4,0,0,6
2009,20643,ATL,2,0,0,0,0,2
2009,20643,OTT,2,1,0,0,0,3
2009,20644,BUF,1,0,0,0,0,1
2009,20644,CHI,2,1,1,0,0,4
2009,20645,ANA,2,1,0,0,0,3
2009,20645,DET,1,1,2,0,0,4
2009,20646,BOS,0,1,1,0,0,2
2009,20646,NYI,0,0,1,0,0,1
2009,20647,CAR,0,1,3,0,0,4
2009,20647,TOR,1,3,2,0,0,6
2009,20648,MTL,1,1,1,0,0,3
2009,20648,NSH,0,1,1,0,0,2
2009,20649,PHI,0,1,0,0,0,1
2009,20649,TBL,0,3,1,0,0,4
2009,20650,EDM,1,0,0,0,0,1
2009,20650,MIN,2,0,3,0,0,5
2009,20651,COL,0,0,2,0,0,2
2009,20651,STL,1,1,3,0,0,5
2009,20652,BUF,0,1,3,0,1,5
2009,20652,DAL,2,1,1,0,0,4
2009,20653,PHX,2,2,0,0,0,4
2009,20653,VAN,0,0,1,0,0,1
2009,20654,DET,2,2,0,0,0,4
2009,20654,LAK,0,0,0,0,0,0
2009,20655,CGY,0,2,1,0,0,3
2009,20655,SJS,1,1,0,0,0,2
2009,20656,CBJ,0,1,0,0,0,1
2009,20656,NJD,0,0,2,0,0,2
2009,20657,ANA,0,1,0,0,0,1
2009,20657,PIT,1,1,1,0,0,3
2009,20658,ATL,0,2,1,1,0,4
2009,20658,TOR,3,0,0,0,0,3
2009,20659,FLA,0,2,0,0,0,2
2009,20659,PHI,2,0,0,0,1,3
2009,20660,CHI,1,0,1,0,0,2
2009,20660,NYR,0,1,1,1,0,3
2009,20661,COL,1,1,0,0,0,2
2009,20661,EDM,2,0,1,0,0,3
2009,20662,DAL,0,0,2,0,1,3
2009,20662,LAK,0,0,2,0,0,2
2009,20663,BUF,2,1,0,0,0,3
2009,20663,CAR,0,0,1,0,0,1
2009,20664,MTL,2,1,1,0,1,5
2009,20664,OTT,1,0,3,0,0,4
2009,20665,NJD,1,2,0,0,0,3
2009,20665,NYI,0,0,1,0,0,1
2009,20666,BOS,0,1,0,0,0,1
2009,20666,WSH,0,1,1,0,0,2
2009,20667,FLA,1,3,0,0,0,4
2009,20667,TBL,3,0,0,0,0,3
2009,20668,ATL,4,1,2,0,0,7
2009,20668,NSH,0,1,1,0,0,2
2009,20669,CHI,1,0,0,1,0,2
2009,20669,STL,0,0,1,0,0,1
2009,20670,ANA,0,1,2,0,0,3
2009,20670,MIN,0,0,0,0,0,0
2009,20671,CGY,0,1,2,0,0,3
2009,20671,PHX,1,2,1,0,0,4
2009,20672,DET,1,3,1,0,0,5
2009,20672,SJS,2,2,2,0,0,6
2009,20673,NYR,0,0,0,0,0,0
2009,20673,PIT,2,1,0,0,0,3
2009,20674,CGY,0,1,1,0,0,2
2009,20674,COL,2,2,2,0,0,6
2009,20675,EDM,3,1,2,0,0,6
2009,20675,PHX,1,2,0,0,0,3
2009,20676,CBJ,1,2,2,0,1,6
2009,20676,VAN,1,2,2,0,0,5
2009,20677,BOS,1,0,3,0,0,4
2009,20677,STL,1,1,2,0,1,5
2009,20678,NYI,0,0,1,0,0,1
2009,20678,WSH,1,0,0,1,0,2
2009,20679,CAR,0,2,0,0,0,2
2009,20679,TOR,0,0,0,0,0,0
2009,20680,DAL,1,1,0,0,0,2
2009,20680,TBL,1,0,3,0,0,4
2009,20681,BUF,0,1,1,0,1,3
2009,20681,FLA,1,0,1,0,0,2
2009,20682,CHI,0,1,0,0,0,1
2009,20682,MIN,2,1,1,0,0,4
2009,20683,NSH,0,0,1,0,0,1
2009,20683,NJD,0,2,1,0,0,3
2009,20684,ANA,1,1,0,0,0,2
2009,20684,NYR,1,1,2,0,0,4
2009,20685,ATL,2,1,1,0,0,4
2009,20685,MTL,0,2,0,0,0,2
2009,20686,OTT,2,0,1,0,0,3
2009,20686,WSH,0,2,0,0,0,2
2009,20687,CAR,1,1,0,0,0,2
2009,20687,PIT,1,0,0,0,0,1
2009,20688,LAK,1,3,1,0,0,5
2009,20688,MIN,1,1,0,0,0,2
2009,20689,CBJ,0,3,0,0,0,3
2009,20689,EDM,1,1,2,0,0,4
2009,20690,DET,1,2,0,0,0,3
2009,20690,PHX,1,2,3,0,0,6
2009,20691,SJS,0,0,1,1,0,2
2009,20691,VAN,1,0,0,0,0,1
2009,20692,MTL,0,1,1,0,0,2
2009,20692,NJD,1,2,2,0,0,5
2009,20693,ANA,0,1,0,0,0,1
2009,20693,NYI,2,0,0,0,0,2
2009,20694,ATL,0,0,3,0,0,3
2009,20694,PHI,2,1,2,0,0,5
2009,20695,BOS,1,0,2,0,1,4
2009,20695,TOR,1,2,0,0,0,3
2009,20696,BUF,0,3,0,0,0,3
2009,20696,TBL,2,3,0,0,0,5
2009,20697,DAL,0,2,2,0,0,4
2009,20697,FLA,1,0,0,0,0,1
2009,20698,CHI,0,0,0,0,0,0
2009,20698,STL,1,0,1,0,0,2
2009,20699,COL,1,2,2,0,0,5
2009,20699,LAK,1,5,0,0,0,6
2009,20700,CGY,1,2,1,0,1,5
2009,20700,CBJ,2,1,1,0,0,4
2009,20701,BOS,1,1,0,1,0,3
2009,20701,WSH,2,0,0,0,0,2
2009,20702,CAR,1,0,1,0,0,2
2009,20702,NYR,2,0,1,0,0,3
2009,20703,CBJ,0,2,0,1,0,3
2009,20703,DET,1,1,0,0,0,2
2009,20704,NJD,1,1,2,0,0,4
2009,20704,OTT,0,1,0,0,0,1
2009,20705,MTL,2,0,1,0,0,3
2009,20705,TBL,1,3,1,0,0,5
2009,20706,FLA,1,2,0,0,0,3
2009,20706,PHI,1,0,1,0,0,2
2009,20707,MIN,1,4,1,0,0,6
2009,20707,TOR,0,1,0,0,0,1
2009,20708,ATL,0,0,0,0,0,0
2009,20708,DAL,1,1,0,0,0,2
2009,20709,COL,0,0,0,0,0,0
2009,20709,SJS,1,1,1,0,0,3
2009,20710,BUF,3,4,3,0,0,10
2009,20710,EDM,0,1,1,0,0,2
2009,20711,ANA,1,4,2,0,0,7
2009,20711,PHX,1,2,0,0,0,3
2009,20712,NYR,1,0,1,0,0,2
2009,20712,PIT,1,0,5,0,0,6
2009,20713,BUF,0,2,0,0,0,2
2009,20713,CGY,1,1,3,0,0,5
2009,20714,ANA,1,1,0,0,0,2
2009,20714,CHI,2,1,0,0,0,3
2009,20715,NSH,1,2,2,0,0,5
2009,20715,VAN,0,3,0,0,0,3
2009,20716,BOS,0,0,3,0,0,3
2009,20716,NJD,1,1,1,1,0,4
2009,20717,CAR,0,2,1,0,0,3
2009,20717,TBL,1,0,1,0,0,2
2009,20718,ATL,0,0,4,0,0,4
2009,20718,NYI,4,0,1,0,0,5
2009,20719,MTL,0,1,0,0,0,1
2009,20719,FLA,2,1,2,0,0,5
2009,20720,DAL,3,1,0,0,0,4
2009,20720,DET,0,2,0,0,0,2
2009,20721,OTT,1,0,2,0,0,3
2009,20721,STL,1,0,0,0,0,1
2009,20722,COL,1,2,1,0,0,4
2009,20722,TOR,1,3,3,0,0,7
2009,20723,CHI,0,0,2,0,0,2
2009,20723,LAK,2,1,2,0,0,5
2009,20724,PHX,0,0,0,0,0,0
2009,20724,SJS,0,1,1,0,0,2
2009,20725,NJD,1,0,2,1,0,4
2009,20725,PIT,2,0,1,0,0,3
2009,20726,CBJ,0,1,0,0,0,1
2009,20726,OTT,0,0,0,0,0,0
2009,20727,PHI,1,2,3,0,0,6
2009,20727,TBL,1,0,0,0,0,1
2009,20728,CGY,0,2,1,0,0,3
2009,20728,NSH,0,0,1,0,0,1
2009,20729,EDM,2,1,0,0,0,3
2009,20729,MIN,0,0,1,0,0,1
2009,20730,DET,1,1,0,0,0,2
2009,20730,WSH,1,1,2,0,0,4
2009,20731,BOS,0,1,0,0,0,1
2009,20731,NYR,0,0,0,0,0,0
2009,20732,MTL,1,1,2,0,0,4
2009,20732,LAK,1,2,0,0,0,3
2009,20733,ANA,2,1,1,0,0,4
2009,20733,COL,1,2,0,0,0,3
2009,20734,PIT,1,0,3,0,0,4
2009,20734,TOR,1,2,2,0,0,5
2009,20735,FLA,0,0,1,0,0,1
2009,20735,NYI,1,0,2,0,0,3
2009,20736,CBJ,1,1,1,0,0,3
2009,20736,DAL,3,2,2,0,0,7
2009,20737,ATL,0,0,0,0,0,0
2009,20737,CAR,2,0,0,0,0,2
2009,20738,PHI,0,0,0,0,0,0
2009,20738,STL,1,2,1,0,0,4
2009,20739,BUF,0,2,0,0,0,2
2009,20739,PHX,0,0,0,0,0,0
2009,20740,MIN,2,0,1,1,0,4
2009,20740,VAN,0,1,2,0,0,3
2009,20741,CHI,1,2,1,0,0,4
2009,20741,SJS,1,0,1,0,0,2
2009,20742,OTT,1,1,2,0,0,4
2009,20742,WSH,2,4,1,0,0,7
2009,20743,BOS,1,1,1,0,0,3
2009,20743,MTL,1,0,0,0,0,1
2009,20744,EDM,0,0,1,0,0,1
2009,20744,NSH,0,1,1,0,0,2
2009,20745,DET,0,3,0,0,1,4
2009,20745,STL,0,2,1,0,0,3
2009,20746,CGY,1,2,0,0,0,3
2009,20746,COL,1,3,0,0,0,4
2009,20747,ANA,0,1,2,0,0,3
2009,20747,BUF,1,0,1,0,0,2
2009,20748,NJD,0,1,1,0,0,2
2009,20748,WSH,2,1,2,0,0,5
2009,20749,NYI,0,3,0,0,0,3
2009,20749,TBL,0,0,1,0,0,1
2009,20750,ATL,0,0,1,0,1,2
2009,20750,NYR,0,0,1,0,0,1
2009,20751,CBJ,2,0,0,0,0,2
2009,20751,STL,2,1,1,0,0,4
2009,20752,FLA,1,0,2,1,0,4
2009,20752,TOR,2,1,0,0,0,3
2009,20753,MTL,1,2,1,0,0,4
2009,20753,PIT,1,0,1,0,0,2
2009,20754,LAK,0,0,1,0,0,1
2009,20754,OTT,0,0,0,0,0,0
2009,20755,NSH,1,1,0,0,0,2
2009,20755,PHX,0,0,1,0,0,1
2009,20756,CGY,1,0,0,0,0,1
2009,20756,DAL,1,1,1,0,0,3
2009,20757,CHI,0,2,1,0,0,3
2009,20757,EDM,1,0,0,0,0,1
2009,20758,CAR,0,2,1,0,0,3
2009,20758,VAN,2,1,1,0,0,4
2009,20759,BOS,0,1,2,0,0,3
2009,20759,PHI,0,1,0,0,0,1
2009,20760,BUF,2,1,2,0,0,5
2009,20760,TOR,0,0,0,0,0,0
2009,20761,PIT,0,0,3,1,0,4
2009,20761,TBL,1,2,0,0,0,3
2009,20762,DET,1,2,2,0,0,5
2009,20762,PHX,1,1,2,0,0,4
2009,20763,ANA,0,0,0,0,0,0
2009,20763,MIN,1,1,1,0,0,3
2009,20764,LAK,1,3,1,0,0,5
2009,20764,WSH,1,1,2,0,0,4
2009,20765,BOS,1,1,1,0,1,4
2009,20765,OTT,0,1,2,0,0,3
2009,20766,FLA,2,1,0,0,0,3
2009,20766,NYI,0,2,0,0,0,2
2009,20767,ANA,1,1,0,0,0,2
2009,20767,NSH,1,2,1,0,0,4
2009,20768,EDM,0,1,0,0,1,2
2009,20768,STL,0,0,1,0,0,1
2009,20769,COL,0,1,2,0,0,3
2009,20769,DAL,1,0,1,0,0,2
2009,20770,CGY,2,0,0,0,0,2
2009,20770,CHI,2,1,2,0,0,5
2009,20771,CAR,0,2,1,0,1,4
2009,20771,SJS,1,2,0,0,0,3
2009,20772,BUF,0,2,1,0,0,3
2009,20772,MTL,0,1,1,0,0,2
2009,20773,CBJ,0,0,1,0,0,1
2009,20773,PIT,0,3,1,0,0,4
2009,20774,ATL,0,1,0,0,0,1
2009,20774,NJD,3,2,0,0,0,5
2009,20775,MIN,0,0,0,0,0,0
2009,20775,NSH,0,1,1,0,0,2
2009,20776,DAL,3,1,6,0,0,10
2009,20776,NYR,1,1,0,0,0,2
2009,20777,BOS,3,0,0,0,0,3
2009,20777,PHI,1,2,0,1,0,4
2009,20778,DET,5,1,2,0,0,8
2009,20778,EDM,0,0,3,0,0,3
2009,20779,ANA,1,1,0,0,0,2
2009,20779,CGY,0,0,1,0,0,1
2009,20780,MTL,0,1,1,0,0,2
2009,20780,TOR,1,1,3,0,0,5
2009,20781,BUF,0,0,2,0,0,2
2009,20781,OTT,0,2,0,0,1,3
2009,20782,LAK,0,3,0,0,0,3
2009,20782,NJD,0,0,1,0,0,1
2009,20783,FLA,1,0,0,0,0,1
2009,20783,WSH,1,0,2,0,0,3
2009,20784,CBJ,2,0,0,1,0,3
2009,20784,SJS,0,1,1,0,0,2
2009,20785,NYI,0,0,0,0,0,0
2009,20785,TBL,0,0,1,0,0,1
2009,20786,COL,1,0,0,0,0,1
2009,20786,STL,0,3,1,0,0,4
2009,20787,CAR,1,3,3,0,0,7
2009,20787,PHX,1,1,0,0,0,2
2009,20788,CHI,0,1,2,0,0,3
2009,20788,VAN,3,3,1,0,0,7
2009,20789,DET,0,1,2,0,0,3
2009,20789,PIT,0,0,0,0,0,0
2009,20790,ATL,0,0,2,0,0,2
2009,20790,PHI,1,1,1,0,0,3
2009,20791,EDM,1,0,1,0,0,2
2009,20791,MIN,1,0,1,0,1,3
2009,20792,DAL,2,0,2,0,0,4
2009,20792,NSH,0,1,0,0,0,1
2009,20793,NJD,0,2,1,0,0,3
2009,20793,NYR,0,0,0,0,0,0
2009,20794,CGY,1,3,2,0,0,6
2009,20794,MTL,2,0,0,0,0,2
2009,20795,BOS,2,0,0,0,0,2
2009,20795,SJS,1,0,4,0,0,5
2009,20796,LAK,1,1,1,0,1,4
2009,20796,NYI,1,2,0,0,0,3
2009,20797,COL,0,0,0,0,0,0
2009,20797,CBJ,0,0,3,0,0,3
2009,20798,ATL,1,1,1,0,0,3
2009,20798,TBL,1,0,0,0,0,1
2009,20799,FLA,0,1,3,1,0,5
2009,20799,TOR,1,2,1,0,0,4
2009,20800,DET,2,1,2,0,0,5
2009,20800,NSH,0,2,1,0,0,3
2009,20801,STL,2,1,1,0,0,4
2009,20801,VAN,0,2,4,0,0,6
2009,20802,NJD,1,1,2,0,0,4
2009,20802,NYI,1,1,0,0,0,2
2009,20803,NYR,1,3,0,0,1,5
2009,20803,WSH,2,2,0,0,0,4
2009,20804,ATL,0,1,0,0,0,1
2009,20804,CHI,0,2,1,0,0,3
2009,20805,BUF,0,0,1,0,0,1
2009,20805,OTT,1,2,0,0,0,3
2009,20806,PIT,0,1,0,0,1,2
2009,20806,SJS,0,0,1,0,0,1
2009,20807,COL,1,0,1,0,0,2
2009,20807,MIN,1,1,1,0,0,3
2009,20808,DAL,0,0,0,0,0,0
2009,20808,PHX,0,1,0,0,0,1
2009,20809,MTL,1,0,1,0,0,2
2009,20809,EDM,4,2,1,0,0,7
2009,20810,ANA,0,1,1,1,0,3
2009,20810,CGY,1,1,0,0,0,2
2009,20811,OTT,1,2,2,0,0,5
2009,20811,PHI,0,0,2,0,0,2
2009,20812,CAR,0,0,0,0,0,0
2009,20812,FLA,2,3,0,0,0,5
2009,20813,TBL,4,0,2,0,0,6
2009,20813,TOR,1,2,1,0,0,4
2009,20814,DET,1,3,0,0,0,4
2009,20814,MIN,1,0,1,0,0,2
2009,20815,NSH,1,0,2,0,1,4
2009,20815,STL,2,1,0,0,0,3
2009,20816,PHX,2,1,0,0,0,3
2009,20816,VAN,0,1,3,0,0,4
2009,20817,CGY,1,0,1,0,0,2
2009,20817,LAK,0,0,0,0,0,0
2009,20818,BOS,0,0,0,0,0,0
2009,20818,NJD,0,1,0,0,0,1
2009,20819,CBJ,1,1,1,0,0,3
2009,20819,DET,0,1,1,0,0,2
2009,20820,BUF,3,1,1,0,1,6
2009,20820,SJS,1,2,2,0,0,5
2009,20821,FLA,0,1,0,0,1,2
2009,20821,NYR,1,0,0,0,0,1
2009,20822,CHI,0,0,0,0,0,0
2009,20822,STL,0,0,1,0,0,1
2009,20823,DAL,0,2,0,0,0,2
2009,20823,VAN,1,0,0,0,0,1
2009,20824,MTL,2,0,2,0,0,4
2009,20824,COL,0,1,1,0,0,2
2009,20825,NYI,0,0,1,0,0,1
2009,20825,PHI,2,0,3,0,0,5
2009,20826,EDM,2,0,0,0,1,3
2009,20826,LAK,0,1,1,0,0,2
2009,20827,PIT,2,0,0,0,0,2
2009,20827,TOR,0,1,5,0,0,6
2009,20828,CAR,0,0,1,0,0,1
2009,20828,CBJ,1,1,3,0,0,5
2009,20829,TBL,0,1,0,0,0,1
2009,20829,WSH,3,1,1,0,0,5
2009,20830,BOS,0,1,1,0,0,2
2009,20830,NSH,1,1,0,0,1,3
2009,20831,MIN,3,0,0,0,0,3
2009,20831,OTT,0,3,2,0,0,5
2009,20832,CHI,1,2,3,0,0,6
2009,20832,DAL,0,0,2,0,0,2
2009,20833,CGY,1,4,2,0,0,7
2009,20833,PHX,1,1,3,0,0,5
2009,20834,NJD,3,0,3,0,0,6
2009,20834,SJS,2,2,1,0,0,5
2009,20835,NYR,0,1,1,0,0,2
2009,20835,PHI,1,4,0,0,0,5
2009,20836,FLA,0,1,1,0,0,2
2009,20836,WSH,1,1,2,0,0,4
2009,20837,COL,1,1,3,0,1,6
2009,20837,DET,0,3,2,0,0,5
2009,20838,BUF,0,0,0,0,0,0
2009,20838,CAR,2,0,1,0,0,3
2009,20839,ANA,1,1,2,0,0,4
2009,20839,ATL,2,4,2,0,0,8
2009,20840,MTL,1,0,1,0,0,2
2009,20840,VAN,2,1,1,0,0,4
2009,20841,NYI,1,1,0,0,1,3
2009,20841,PIT,1,1,0,0,0,2
2009,20842,CBJ,0,2,0,0,0,2
2009,20842,DAL,1,1,0,0,1,3
2009,20843,NYR,0,1,0,0,0,1
2009,20843,STL,0,1,1,0,0,2
2009,20844,NSH,0,0,0,0,0,0
2009,20844,OTT,2,0,0,0,0,2
2009,20845,EDM,0,1,2,0,0,3
2009,20845,PHX,0,1,0,0,0,1
2009,20846,ATL,4,1,1,0,1,7
2009,20846,LAK,2,1,3,0,0,6
2009,20847,BOS,1,1,3,0,0,5
2009,20847,CAR,1,0,0,0,0,1
2009,20848,BUF,3,0,1,0,0,4
2009,20848,TOR,0,1,0,0,0,1
2009,20849,CHI,1,1,3,0,0,5
2009,20849,TBL,1,2,0,0,0,3
2009,20850,FLA,1,2,1,0,0,4
2009,20850,NJD,0,0,0,0,0,0
2009,20851,COL,1,1,0,1,0,3
2009,20851,OTT,1,1,0,0,0,2
2009,20852,CGY,1,1,1,0,0,3
2009,20852,VAN,1,1,1,0,1,4
2009,20853,EDM,2,0,0,0,0,2
2009,20853,SJS,1,3,0,0,0,4
2009,20854,NYI,1,0,0,0,0,1
2009,20854,NYR,1,1,1,0,0,3
2009,20855,CBJ,2,2,0,0,0,4
2009,20855,STL,0,1,2,0,0,3
2009,20856,MTL,2,0,1,0,0,3
2009,20856,WSH,2,0,1,0,1,4
2009,20857,DET,2,2,2,0,0,6
2009,20857,NSH,1,1,0,0,0,2
2009,20858,ANA,0,1,2,0,0,3
2009,20858,LAK,1,1,2,0,0,4
2009,20859,CAR,3,2,1,0,0,6
2009,20859,NYI,1,0,1,0,0,2
2009,20860,BUF,0,3,0,0,0,3
2009,20860,PHI,1,2,3,0,0,6
2009,20861,MTL,0,2,2,0,0,4
2009,20861,PIT,1,1,3,0,0,5
2009,20862,CBJ,1,1,1,0,1,4
2009,20862,TOR,1,2,0,0,0,3
2009,20863,OTT,0,2,0,0,0,2
2009,20863,VAN,3,1,1,0,0,5
2009,20864,NJD,0,1,1,0,1,3
2009,20864,TBL,2,0,0,0,0,2
2009,20865,CHI,1,0,3,0,0,4
2009,20865,FLA,0,0,0,0,0,0
2009,20866,NSH,1,0,0,0,0,1
2009,20866,STL,0,1,0,1,0,2
2009,20867,CGY,1,1,0,1,0,3
2009,20867,MIN,0,2,0,0,0,2
2009,20868,DAL,2,1,1,0,0,4
2009,20868,EDM,1,1,0,0,0,2
2009,20869,ATL,1,1,1,0,0,3
2009,20869,PHX,1,2,0,0,1,4
2009,20870,LAK,1,1,0,0,0,2
2009,20870,SJS,2,2,0,0,0,4
2009,20871,COL,1,1,2,0,0,4
2009,20871,WSH,1,0,0,0,0,1
2009,20872,CAR,1,1,2,0,0,4
2009,20872,TBL,0,1,0,0,0,1
2009,20873,ANA,1,0,1,0,0,2
2009,20873,DET,2,1,2,0,0,5
2009,20874,PHI,1,0,3,0,0,4
2009,20874,PIT,0,3,2,0,0,5
2009,20875,MTL,2,3,0,0,0,5
2009,20875,OTT,0,2,1,0,0,3
2009,20876,CHI,1,2,0,0,0,3
2009,20876,DAL,0,0,1,0,0,1
2009,20877,LAK,1,1,1,0,0,3
2009,20877,PHX,1,3,2,0,0,6
2009,20878,ATL,0,0,1,0,0,1
2009,20878,SJS,0,0,3,0,0,3
2009,20879,BUF,2,1,1,0,0,4
2009,20879,NYR,0,0,2,0,0,2
2009,20880,TOR,1,1,0,0,0,2
2009,20880,VAN,0,1,1,0,1,3
2009,20881,NJD,0,0,0,0,0,0
2009,20881,NYI,1,1,2,0,0,4
2009,20882,BOS,0,0,0,0,0,0
2009,20882,FLA,0,0,2,0,0,2
2009,20883,ANA,2,2,1,0,0,5
2009,20883,CBJ,0,1,1,0,0,2
2009,20884,DET,0,1,1,0,0,2
2009,20884,MIN,2,2,1,0,0,5
2009,20885,NSH,0,0,0,1,0,1
2009,20885,STL,0,0,0,0,0,0
2009,20886,CGY,0,1,1,0,1,3
2009,20886,EDM,1,0,1,0,0,2
2009,20887,PIT,1,1,0,0,0,2
2009,20887,WSH,2,3,0,0,0,5
2009,20888,CAR,1,2,2,0,0,5
2009,20888,COL,1,1,0,0,0,2
2009,20889,BOS,2,1,0,0,0,3
2009,20889,TBL,2,1,1,0,0,4
2009,20890,NYR,0,0,2,0,0,2
2009,20890,TOR,0,0,2,1,0,3
2009,20891,CHI,0,1,0,0,0,1
2009,20891,MIN,0,1,1,0,0,2
2009,20892,DAL,0,0,0,0,0,0
2009,20892,SJS,0,0,1,0,0,1
2009,20893,BOS,2,1,3,0,0,6
2009,20893,FLA,1,0,0,0,0,1
2009,20894,ANA,1,2,0,0,0,3
2009,20894,BUF,1,0,1,0,0,2
2009,20895,PHI,0,1,3,0,0,4
2009,20895,WSH,1,1,0,0,0,2
2009,20896,ATL,3,1,0,0,0,4
2009,20896,COL,1,1,1,0,0,3
2009,20897,MTL,1,1,1,0,0,3
2009,20897,VAN,0,0,0,0,0,0
2009,20898,CAR,1,1,0,0,0,2
2009,20898,OTT,3,1,0,0,0,4
2009,20899,CHI,0,3,0,0,0,3
2009,20899,NSH,0,1,4,0,0,5
2009,20900,LAK,0,1,0,0,1,2
2009,20900,MIN,0,1,0,0,0,1
2009,20901,PHX,1,0,0,0,0,1
2009,20901,STL,0,2,0,0,0,2
2009,20902,CGY,1,2,1,0,0,4
2009,20902,CBJ,1,0,0,0,0,1
2009,20903,EDM,2,1,2,0,0,5
2009,20903,TBL,0,2,1,0,0,3
2009,20904,LAK,0,0,0,0,0,0
2009,20904,PHI,0,1,1,0,0,2
2009,20905,NYR,0,1,0,0,0,1
2009,20905,TOR,0,0,1,0,1,2
2009,20906,NYI,0,0,0,0,0,0
2009,20906,PIT,0,0,1,0,0,1
2009,20907,DET,2,1,1,0,0,4
2009,20907,SJS,0,1,0,0,0,1
2009,20908,ANA,0,0,0,0,0,0
2009,20908,BOS,1,4,1,0,0,6
2009,20909,COL,0,0,0,0,0,0
2009,20909,NJD,1,1,2,0,0,4
2009,20910,NYI,0,1,3,0,0,4
2009,20910,TOR,1,1,2,0,1,5
2009,20911,FLA,0,0,2,0,0,2
2009,20911,NYR,1,0,0,0,0,1
2009,20912,ATL,1,1,1,0,0,3
2009,20912,WSH,2,1,1,0,0,4
2009,20913,BUF,0,1,0,0,0,1
2009,20913,CAR,0,0,1,0,1,2
2009,20914,OTT,1,0,0,0,0,1
2009,20914,SJS,0,2,0,0,0,2
2009,20915,NSH,1,1,2,0,0,4
2009,20915,PHX,0,1,0,0,0,1
2009,20916,DAL,1,0,0,0,0,1
2009,20916,STL,1,0,2,0,0,3
2009,20917,CBJ,0,0,1,0,0,1
2009,20917,EDM,0,0,0,0,0,0
2009,20918,MTL,3,0,0,1,0,4
2009,20918,PHI,2,1,0,0,0,3
2009,20919,DET,0,1,1,0,0,2
2009,20919,LAK,0,0,1,0,0,1
2009,20920,CHI,1,1,2,0,0,4
2009,20920,PIT,2,2,0,1,0,5
2009,20921,CGY,0,3,1,0,0,4
2009,20921,MIN,0,0,1,0,0,1
2009,20922,TBL,0,1,0,0,0,1
2009,20922,VAN,1,0,1,0,0,2
2009,20923,BOS,1,1,1,0,0,3
2009,20923,WSH,1,1,1,1,0,4
2009,20924,FLA,0,1,1,0,0,2
2009,20924,NJD,2,4,1,0,0,7
2009,20925,ANA,2,0,2,0,0,4
2009,20925,DAL,0,2,1,0,0,3
2009,20926,MTL,3,0,0,0,0,3
2009,20926,SJS,0,2,0,0,0,2
2009,20927,OTT,0,2,1,0,0,3
2009,20927,TOR,2,0,1,1,0,4
2009,20928,BUF,0,0,0,0,0,0
2009,20928,NYI,0,1,1,0,0,2
2009,20929,COL,0,1,0,0,0,1
2009,20929,NYR,4,1,1,0,0,6
2009,20930,ATL,0,1,4,0,0,5
2009,20930,CAR,2,0,1,0,0,3
2009,20931,DET,0,0,0,0,0,0
2009,20931,NSH,5,1,2,0,0,8
2009,20932,PHX,0,0,1,0,0,1
2009,20932,STL,0,1,2,0,0,3
2009,20933,EDM,1,2,0,0,0,3
2009,20933,MIN,2,0,0,0,0,2
2009,20934,NJD,1,1,1,0,0,3
2009,20934,PHI,0,0,0,0,0,0
2009,20935,FLA,4,1,1,0,0,6
2009,20935,WSH,1,0,1,0,0,2
2009,20936,CHI,3,0,1,0,0,4
2009,20936,LAK,2,0,0,0,0,2
2009,20937,DAL,0,0,1,0,0,1
2009,20937,PIT,2,2,0,0,0,4
2009,20938,CGY,1,3,2,0,0,6
2009,20938,TBL,1,4,3,0,0,8
2009,20939,CBJ,0,0,1,0,0,1
2009,20939,VAN,1,1,1,0,0,3
2009,20940,COL,0,1,1,0,0,2
2009,20940,NYI,1,2,1,0,0,4
2009,20941,BOS,1,0,1,0,0,2
2009,20941,PHI,0,1,3,0,0,4
2009,20942,CAR,1,4,0,0,0,5
2009,20942,WSH,0,1,1,0,0,2
2009,20943,ATL,2,0,1,0,0,3
2009,20943,FLA,1,3,0,0,0,4
2009,20944,CBJ,2,2,1,0,0,5
2009,20944,LAK,1,3,0,0,0,4
2009,20945,NJD,1,0,1,1,0,3
2009,20945,TOR,0,0,2,0,0,2
2009,20946,CGY,3,1,2,0,0,6
2009,20946,OTT,2,0,1,0,0,3
2009,20947,PIT,2,1,0,0,0,3
2009,20947,TBL,1,0,0,0,0,1
2009,20948,EDM,2,0,3,0,0,5
2009,20948,NSH,2,1,2,1,0,6
2009,20949,ANA,0,2,0,0,0,2
2009,20949,CHI,2,0,0,1,0,3
2009,20950,DET,1,1,3,0,0,5
2009,20950,STL,0,0,0,0,0,0
2009,20951,MIN,2,0,0,0,0,2
2009,20951,VAN,1,2,1,0,0,4
2009,20952,DAL,1,1,2,0,0,4
2009,20952,SJS,1,0,0,0,0,1
2009,20953,BUF,1,2,2,0,0,5
2009,20953,MTL,0,0,1,0,0,1
2009,20954,COL,1,0,1,0,0,2
2009,20954,DET,1,2,0,0,0,3
2009,20955,BOS,1,0,0,0,0,1
2009,20955,PHX,1,1,0,0,0,2
2009,20956,NYI,0,1,1,0,0,2
2009,20956,NYR,1,1,2,0,0,4
2009,20957,CGY,4,0,1,0,0,5
2009,20957,PHI,0,0,1,0,0,1
2009,20958,TOR,0,0,2,0,0,2
2009,20958,WSH,0,0,1,0,0,1
2009,20959,EDM,0,1,1,0,0,2
2009,20959,OTT,1,2,1,0,0,4
2009,20960,FLA,0,1,0,0,0,1
2009,20960,PIT,0,1,3,0,0,4
2009,20961,CBJ,0,2,0,0,0,2
2009,20961,NSH,0,3,1,0,0,4
2009,20962,DAL,0,4,0,0,0,4
2009,20962,LAK,0,2,2,1,0,5
2009,20963,MIN,0,2,1,1,0,4
2009,20963,SJS,2,1,0,0,0,3
2009,20964,CGY,0,0,1,0,0,1
2009,20964,CAR,3,2,1,0,0,6
2009,20965,BUF,2,1,2,0,0,5
2009,20965,PHX,0,0,1,0,0,1
2009,20966,ATL,1,0,1,0,0,2
2009,20966,MTL,0,0,0,0,0,0
2009,20967,STL,0,2,1,1,0,4
2009,20967,TBL,0,0,3,0,0,3
2009,20968,ANA,0,0,2,0,0,2
2009,20968,DAL,1,1,1,0,0,3
2009,20969,BOS,1,2,2,0,0,5
2009,20969,CHI,0,1,2,0,0,3
2009,20970,NJD,0,2,1,0,0,3
2009,20970,NYI,3,3,1,0,0,7
2009,20971,LAK,2,2,0,0,0,4
2009,20971,MIN,2,0,1,0,0,3
2009,20972,EDM,0,3,1,0,0,4
2009,20972,TOR,0,1,0,0,0,1
2009,20973,BUF,1,1,1,0,0,3
2009,20973,OTT,1,2,3,0,0,6
2009,20974,NSH,0,0,1,0,0,1
2009,20974,PHI,0,2,2,0,0,4
2009,20975,FLA,2,2,1,0,0,5
2009,20975,STL,0,2,1,0,0,3
2009,20976,CBJ,2,2,4,0,0,8
2009,20976,DET,0,1,1,0,0,2
2009,20977,CAR,3,6,0,0,0,9
2009,20977,TBL,1,0,2,0,0,3
2009,20978,SJS,0,1,0,0,0,1
2009,20978,VAN,2,0,1,0,0,3
2009,20979,NYI,0,3,0,0,0,3
2009,20979,PHX,1,0,1,0,0,2
2009,20980,BOS,0,1,2,0,0,3
2009,20980,NYR,0,3,1,0,0,4
2009,20981,PIT,1,2,0,0,1,4
2009,20981,WSH,1,0,2,0,0,3
2009,20982,ATL,2,1,2,0,0,5
2009,20982,CGY,1,0,1,0,0,2
2009,20983,CHI,0,1,0,0,0,1
2009,20983,COL,2,2,1,0,0,5
2009,20984,MTL,0,2,1,0,0,3
2009,20984,DAL,1,0,0,0,0,1
2009,20985,ANA,0,1,1,0,0,2
2009,20985,MIN,1,1,1,0,0,3
2009,20986,CAR,0,1,2,0,0,3
2009,20986,NYR,0,0,0,0,0,0
2009,20987,OTT,0,2,0,0,0,2
2009,20987,TOR,1,0,0,0,0,1
2009,20988,LAK,2,1,0,0,0,3
2009,20988,VAN,0,1,1,0,0,2
2009,20989,CGY,1,0,1,0,0,2
2009,20989,NJD,0,2,1,0,0,3
2009,20990,BUF,1,0,1,0,0,2
2009,20990,PHI,1,0,4,0,0,5
2009,20991,BOS,0,0,0,0,0,0
2009,20991,CBJ,0,0,2,0,0,2
2009,20992,NYI,2,0,0,0,0,2
2009,20992,TOR,1,0,1,1,0,3
2009,20993,MTL,1,1,1,1,0,4
2009,20993,EDM,0,3,0,0,0,3
2009,20994,FLA,0,3,0,0,0,3
2009,20994,PIT,1,0,2,0,1,4
2009,20995,DET,1,0,1,1,0,3
2009,20995,PHX,1,0,1,0,0,2
2009,20996,NSH,1,0,0,0,0,1
2009,20996,WSH,0,1,0,1,0,2
2009,20997,MIN,0,1,3,0,0,4
2009,20997,SJS,2,1,1,1,0,5
2009,20998,DAL,0,2,0,0,0,2
2009,20998,STL,3,2,0,0,0,5
2009,20999,ATL,0,2,1,0,0,3
2009,20999,COL,0,0,0,0,0,0
2009,21000,OTT,1,1,0,1,0,3
2009,21000,TBL,1,1,0,0,0,2
2009,21001,CAR,1,0,1,0,0,2
2009,21001,CHI,0,1,1,0,1,3
2009,21002,ANA,1,2,0,1,0,4
2009,21002,VAN,0,2,1,0,0,3
2009,21003,BOS,3,0,2,0,0,5
2009,21003,OTT,1,0,2,0,0,3
2009,21004,BUF,2,0,1,0,0,3
2009,21004,FLA,1,0,0,0,0,1
2009,21005,NJD,2,2,1,0,0,5
2009,21005,PHX,1,0,1,0,0,2
2009,21006,PHI,0,1,0,0,0,1
2009,21006,WSH,1,1,0,0,0,2
2009,21007,CBJ,1,1,1,0,1,4
2009,21007,PIT,0,0,3,0,0,3
2009,21008,TBL,0,2,2,0,0,4
2009,21008,TOR,1,0,0,0,0,1
2009,21009,MTL,1,0,1,0,0,2
2009,21009,NYI,1,0,1,1,0,3
2009,21010,CGY,1,1,3,0,1,6
2009,21010,DET,2,2,1,0,0,5
2009,21011,NSH,2,0,0,0,0,2
2009,21011,NYR,1,2,1,0,0,4
2009,21012,SJS,1,0,0,0,0,1
2009,21012,STL,1,1,1,0,0,3
2009,21013,CAR,1,0,1,0,0,2
2009,21013,DAL,0,3,0,0,0,3
2009,21014,COL,0,1,0,0,1,2
2009,21014,MIN,1,0,0,0,0,1
2009,21015,ATL,2,1,0,1,0,4
2009,21015,EDM,1,2,0,0,0,3
2009,21016,CHI,0,2,1,0,0,3
2009,21016,CBJ,2,1,2,0,0,5
2009,21017,LAK,0,0,2,0,0,2
2009,21017,VAN,2,0,2,0,0,4
2009,21018,BOS,2,0,0,0,0,2
2009,21018,NYI,0,1,0,0,0,1
2009,21019,NYR,1,0,1,0,0,2
2009,21019,PHI,1,1,2,0,0,4
2009,21020,DET,0,4,1,0,0,5
2009,21020,STL,1,1,0,0,0,2
2009,21021,OTT,1,0,2,0,1,4
2009,21021,PIT,1,2,0,0,0,3
2009,21022,ATL,1,0,2,0,1,4
2009,21022,BUF,0,3,0,0,0,3
2009,21023,CGY,3,1,2,0,0,6
2009,21023,TOR,3,2,3,0,0,8
2009,21024,MTL,1,0,0,0,0,1
2009,21024,NJD,2,0,1,0,0,3
2009,21025,CAR,1,2,1,0,0,4
2009,21025,WSH,2,2,0,0,1,5
2009,21026,FLA,1,1,1,0,0,3
2009,21026,TBL,0,1,2,0,1,4
2009,21027,DAL,1,1,0,1,0,3
2009,21027,MIN,0,2,0,0,0,2
2009,21028,COL,1,0,1,1,0,3
2009,21028,EDM,1,0,1,0,0,2
2009,21029,NSH,0,1,1,0,0,2
2009,21029,PHX,0,0,0,0,0,0
2009,21030,LAK,0,1,0,0,0,1
2009,21030,SJS,1,0,0,0,1,2
2009,21031,NYR,1,1,2,0,0,4
2009,21031,PHI,0,1,0,0,0,1
2009,21032,BOS,2,1,1,0,0,4
2009,21032,PIT,2,0,4,0,0,6
2009,21033,CHI,0,1,1,0,0,2
2009,21033,NYI,0,3,1,0,0,4
2009,21034,CBJ,0,0,0,0,0,0
2009,21034,DET,2,1,1,0,0,4
2009,21035,MIN,0,1,2,0,0,3
2009,21035,STL,1,3,1,0,0,5
2009,21036,ANA,0,0,0,0,0,0
2009,21036,SJS,0,1,0,0,0,1
2009,21037,COL,0,1,1,0,0,2
2009,21037,VAN,3,0,1,0,0,4
2009,21038,ATL,2,2,1,0,0,5
2009,21038,WSH,0,0,1,0,0,1
2009,21039,LAK,1,1,1,0,0,3
2009,21039,NSH,1,2,1,0,0,4
2009,21040,CHI,0,1,1,0,0,2
2009,21040,NJD,2,1,0,0,0,3
2009,21041,MTL,0,1,2,0,0,3
2009,21041,NYR,0,1,2,0,1,4
2009,21042,BUF,2,0,0,0,0,2
2009,21042,OTT,0,2,2,0,0,4
2009,21043,ATL,1,1,0,0,0,2
2009,21043,PIT,2,3,1,0,0,6
2009,21044,TBL,1,2,0,0,0,3
2009,21044,TOR,0,1,2,0,1,4
2009,21045,FLA,0,0,0,0,0,0
2009,21045,WSH,0,1,2,0,0,3
2009,21046,DET,0,1,2,0,0,3
2009,21046,PHI,1,1,0,0,0,2
2009,21047,COL,0,2,0,0,0,2
2009,21047,MIN,0,1,1,0,1,3
2009,21048,EDM,1,0,0,0,1,2
2009,21048,STL,0,1,0,0,0,1
2009,21049,DAL,1,0,1,0,0,2
2009,21049,VAN,1,2,1,0,0,4
2009,21050,PHX,3,0,1,0,0,4
2009,21050,SJS,0,1,2,0,0,3
2009,21051,CAR,1,2,1,0,0,4
2009,21051,NJD,0,1,1,0,0,2
2009,21052,CHI,2,1,0,0,0,3
2009,21052,CBJ,2,1,0,1,0,4
2009,21053,CGY,0,1,1,0,0,2
2009,21053,DAL,0,1,0,0,0,1
2009,21054,ANA,1,1,1,1,0,4
2009,21054,NSH,1,1,1,0,0,3
2009,21055,BOS,1,1,0,0,0,2
2009,21055,LAK,0,0,2,1,0,3
2009,21056,MTL,1,3,0,0,0,4
2009,21056,OTT,3,2,0,0,0,5
2009,21057,TBL,1,1,0,0,0,2
2009,21057,WSH,2,0,3,0,0,5
2009,21058,FLA,1,2,0,0,0,3
2009,21058,TOR,1,0,0,0,0,1
2009,21059,COL,1,0,0,0,0,1
2009,21059,EDM,2,2,4,0,0,8
2009,21060,STL,0,0,0,0,0,0
2009,21060,VAN,0,1,2,0,0,3
2009,21061,ANA,1,0,1,0,1,3
2009,21061,PHX,1,0,1,0,0,2
2009,21062,NSH,2,0,0,0,0,2
2009,21062,SJS,2,0,0,0,1,3
2009,21063,MIN,0,0,0,0,0,0
2009,21063,NJD,0,3,1,0,0,4
2009,21064,CAR,2,1,2,0,0,5
2009,21064,NYI,0,4,0,0,0,4
2009,21065,BUF,0,3,1,0,0,4
2009,21065,PHI,1,3,2,0,0,6
2009,21066,LAK,0,0,1,0,0,1
2009,21066,PIT,2,2,0,0,0,4
2009,21067,ATL,0,0,3,0,0,3
2009,21067,DET,1,2,3,0,0,6
2009,21068,CHI,2,1,1,0,0,4
2009,21068,EDM,2,2,0,0,1,5
2009,21069,CGY,0,2,0,0,0,2
2009,21069,STL,1,0,2,0,0,3
2009,21070,DAL,1,0,1,0,0,2
2009,21070,SJS,2,2,1,0,0,5
2009,21071,MTL,0,2,0,0,0,2
2009,21071,TOR,2,2,1,0,0,5
2009,21072,NYI,0,0,2,0,0,2
2009,21072,OTT,0,4,1,0,0,5
2009,21073,BUF,0,1,2,0,0,3
2009,21073,NYR,1,3,1,0,0,5
2009,21074,CAR,0,1,3,0,0,4
2009,21074,WSH,0,1,0,0,0,1
2009,21075,CBJ,0,0,3,0,0,3
2009,21075,FLA,1,0,0,0,0,1
2009,21076,ATL,2,1,0,0,1,4
2009,21076,TBL,0,3,0,0,0,3
2009,21077,PHX,0,0,0,0,0,0
2009,21077,VAN,0,0,0,0,0,0
2009,21078,BOS,1,3,0,0,0,4
2009,21078,NJD,0,1,0,0,0,1
2009,21079,PHI,1,1,1,0,0,3
2009,21079,PIT,0,0,1,0,0,1
2009,21080,CHI,1,1,2,0,0,4
2009,21080,LAK,0,0,1,0,0,1
2009,21081,EDM,0,0,0,0,0,0
2009,21081,MIN,0,1,2,0,0,3
2009,21082,NYR,1,0,0,0,0,1
2009,21082,OTT,0,1,1,0,0,2
2009,21083,ANA,2,1,3,0,0,6
2009,21083,PHX,0,2,0,0,0,2
2009,21084,COL,0,1,0,0,0,1
2009,21084,SJS,0,2,1,0,0,3
2009,21085,NJD,1,1,0,0,0,2
2009,21085,PHI,1,1,2,0,0,4
2009,21086,CAR,1,1,0,1,0,3
2009,21086,FLA,1,0,1,0,0,2
2009,21087,CGY,1,2,2,0,0,5
2009,21087,DET,0,1,2,0,0,3
2009,21088,TOR,0,1,1,0,1,3
2009,21088,WSH,0,1,1,0,0,2
2009,21089,MIN,0,1,0,0,0,1
2009,21089,NYR,1,1,0,0,0,2
2009,21090,ATL,1,1,1,0,0,3
2009,21090,MTL,1,4,1,0,0,6
2009,21091,CBJ,0,0,1,0,0,1
2009,21091,TBL,0,0,1,1,0,2
2009,21092,ANA,0,1,0,0,1,2
2009,21092,NSH,0,0,1,0,0,1
2009,21093,LAK,0,0,0,0,0,0
2009,21093,STL,0,0,2,0,0,2
2009,21094,DAL,1,0,1,0,0,2
2009,21094,VAN,2,1,2,0,0,5
2009,21095,DET,0,0,3,0,0,3
2009,21095,EDM,1,0,1,0,0,2
2009,21096,BUF,1,0,4,0,0,5
2009,21096,FLA,1,1,1,0,0,3
2009,21097,MIN,2,1,3,0,0,6
2009,21097,NYI,1,0,1,0,0,2
2009,21098,CAR,0,0,2,0,0,2
2009,21098,OTT,0,0,1,0,0,1
2009,21099,CGY,0,0,0,0,0,0
2009,21099,PIT,1,0,1,0,0,2
2009,21100,CHI,3,1,1,0,1,6
2009,21100,SJS,1,2,2,0,0,5
2009,21101,ANA,3,4,0,0,0,7
2009,21101,COL,0,1,1,0,0,2
2009,21102,FLA,1,1,2,0,0,4
2009,21102,PHI,0,2,0,0,0,2
2009,21103,ATL,0,2,2,0,1,5
2009,21103,NYR,1,3,0,0,0,4
2009,21104,CGY,0,0,0,0,0,0
2009,21104,CBJ,2,2,1,0,0,5
2009,21105,MTL,1,0,1,1,0,3
2009,21105,TBL,0,0,2,0,0,2
2009,21106,NSH,0,3,0,0,0,3
2009,21106,SJS,1,1,0,0,0,2
2009,21107,STL,0,2,2,0,0,4
2009,21107,VAN,1,1,0,0,0,2
2009,21108,DAL,0,0,0,0,0,0
2009,21108,LAK,0,0,0,0,1,1
2009,21109,EDM,0,0,2,0,0,2
2009,21109,PHX,1,2,0,0,0,3
2009,21110,TBL,1,1,1,0,0,3
2009,21110,WSH,3,0,2,0,0,5
2009,21111,BUF,2,2,1,0,0,5
2009,21111,TOR,0,1,2,0,0,3
2009,21112,DET,0,0,0,0,0,0
2009,21112,NYI,0,2,0,0,0,2
2009,21113,CHI,1,1,0,1,0,3
2009,21113,NJD,2,0,0,0,0,2
2009,21114,COL,1,0,0,0,0,1
2009,21114,VAN,0,1,3,0,0,4
2009,21115,ANA,1,1,1,0,0,3
2009,21115,EDM,2,2,1,0,0,5
2009,21116,NYR,2,1,0,0,0,3
2009,21116,PIT,2,1,1,0,0,4
2009,21117,BOS,3,4,0,0,0,7
2009,21117,TOR,3,1,1,0,0,5
2009,21118,BUF,1,1,1,0,1,4
2009,21118,MTL,0,3,0,0,0,3
2009,21119,CAR,0,0,2,0,0,2
2009,21119,NJD,1,0,0,0,0,1
2009,21120,NYI,1,1,1,0,0,3
2009,21120,PHI,0,0,3,0,1,4
2009,21121,ATL,2,3,1,0,0,6
2009,21121,OTT,2,0,1,0,0,3
2009,21122,LAK,1,1,1,0,0,3
2009,21122,NSH,1,0,2,1,0,4
2009,21123,DAL,1,1,1,0,0,3
2009,21123,FLA,0,3,3,0,0,6
2009,21124,CBJ,1,0,2,0,0,3
2009,21124,STL,2,1,0,0,1,4
2009,21125,CGY,2,1,0,0,0,3
2009,21125,MIN,1,1,0,0,0,2
2009,21126,PHX,0,2,0,0,0,2
2009,21126,SJS,0,2,1,0,0,3
2009,21127,DET,1,1,1,0,0,3
2009,21127,NSH,1,0,3,0,0,4
2009,21128,CBJ,0,1,1,0,0,2
2009,21128,STL,1,1,3,0,0,5
2009,21129,OTT,2,0,1,0,0,3
2009,21129,TBL,0,0,0,0,0,0
2009,21130,BOS,3,0,1,0,0,4
2009,21130,PHI,1,1,1,0,0,3
2009,21131,CHI,0,0,0,0,0,0
2009,21131,VAN,1,1,2,0,0,4
2009,21132,EDM,0,0,2,0,0,2
2009,21132,MIN,2,0,1,0,0,3
2009,21133,ANA,1,1,2,0,0,4
2009,21133,COL,1,0,0,0,0,1
2009,21134,NJD,0,0,0,0,0,0
2009,21134,NYR,0,3,0,0,0,3
2009,21135,CGY,1,0,0,0,0,1
2009,21135,SJS,1,1,0,0,0,2
2009,21136,DAL,1,2,2,0,0,5
2009,21136,PHX,2,2,1,1,0,6
2009,21137,BOS,1,2,0,0,0,3
2009,21137,TBL,0,0,1,0,0,1
2009,21138,CBJ,1,0,1,0,0,2
2009,21138,NSH,1,0,0,0,0,1
2009,21139,MTL,1,2,1,0,0,4
2009,21139,CHI,0,0,1,0,0,1
2009,21140,FLA,0,3,2,0,0,5
2009,21140,OTT,0,1,1,0,0,2
2009,21141,MIN,0,0,1,0,0,1
2009,21141,VAN,0,1,0,1,0,2
2009,21142,ANA,1,3,1,0,0,5
2009,21142,EDM,1,0,2,0,0,3
2009,21143,DAL,1,2,0,0,0,3
2009,21143,LAK,1,0,1,0,0,2
2009,21144,NYI,1,1,1,0,0,3
2009,21144,WSH,0,2,3,0,0,5
2009,21145,ATL,1,1,0,1,0,3
2009,21145,BUF,1,1,0,0,0,2
2009,21146,PHI,1,0,1,0,0,2
2009,21146,TOR,1,2,0,0,0,3
2009,21147,NJD,1,0,0,0,0,1
2009,21147,PIT,3,2,1,0,0,6
2009,21148,CHI,2,0,1,0,0,3
2009,21148,STL,0,0,1,0,0,1
2009,21149,COL,0,0,0,0,0,0
2009,21149,PHX,1,0,2,0,0,3
2009,21150,BOS,0,1,1,0,0,2
2009,21150,OTT,1,0,0,0,0,1
2009,21151,MTL,2,2,1,0,0,5
2009,21151,NYI,0,1,0,0,0,1
2009,21152,CAR,1,1,2,0,0,4
2009,21152,NYR,1,1,0,0,0,2
2009,21153,DET,0,1,3,0,0,4
2009,21153,STL,0,2,3,0,0,5
2009,21154,CGY,1,1,0,0,0,2
2009,21154,DAL,1,0,0,0,0,1
2009,21155,EDM,0,1,0,0,0,1
2009,21155,SJS,1,1,0,0,0,2
2009,21156,ANA,2,3,0,0,1,6
2009,21156,VAN,2,3,0,0,0,5
2009,21157,LAK,1,0,0,0,0,1
2009,21157,PHX,0,0,2,0,0,2
2009,21158,NJD,0,3,1,1,0,5
2009,21158,TBL,1,1,2,0,0,4
2009,21159,PHI,5,1,2,0,0,8
2009,21159,TOR,0,3,2,0,0,5
2009,21160,BUF,2,1,1,1,0,5
2009,21160,WSH,1,3,0,0,0,4
2009,21161,ATL,0,1,2,0,0,3
2009,21161,FLA,0,1,0,0,0,1
2009,21162,CGY,0,0,0,0,0,0
2009,21162,MIN,3,0,1,0,0,4
2009,21163,CHI,1,1,1,0,0,3
2009,21163,NSH,1,0,0,0,0,1
2009,21164,BOS,1,0,0,0,0,1
2009,21164,NYR,0,0,0,0,0,0
2009,21165,BUF,0,0,2,0,0,2
2009,21165,NJD,2,1,0,0,0,3
2009,21166,MTL,2,2,2,0,0,6
2009,21166,TOR,0,0,2,0,0,2
2009,21167,OTT,1,1,1,0,1,4
2009,21167,PHI,0,2,1,0,0,3
2009,21168,NYI,1,1,1,0,0,3
2009,21168,TBL,0,1,0,0,0,1
2009,21169,CAR,1,1,0,1,0,3
2009,21169,PIT,1,0,1,0,0,2
2009,21170,CBJ,2,1,1,0,0,4
2009,21170,NSH,1,2,1,0,1,5
2009,21171,DAL,1,1,2,1,0,5
2009,21171,STL,0,3,1,0,0,4
2009,21172,EDM,1,1,3,0,0,5
2009,21172,VAN,0,0,3,0,0,3
2009,21173,ANA,2,2,1,0,0,5
2009,21173,SJS,1,1,0,0,0,2
2009,21174,LAK,2,1,3,0,0,6
2009,21174,PHX,0,1,0,0,0,1
2009,21175,ATL,1,2,1,0,0,4
2009,21175,WSH,1,1,4,0,0,6
2009,21176,FLA,2,1,1,0,0,4
2009,21176,PIT,1,0,1,0,0,2
2009,21177,DET,2,0,1,0,0,3
2009,21177,MIN,1,1,0,0,0,2
2009,21178,CHI,0,0,0,1,0,1
2009,21178,CBJ,0,0,0,0,0,0
2009,21179,ANA,1,1,0,0,0,2
2009,21179,SJS,0,2,1,0,0,3
2009,21180,COL,1,1,2,0,0,4
2009,21180,VAN,0,0,1,0,0,1
2009,21181,BUF,0,0,1,0,0,1
2009,21181,DET,0,1,3,0,0,4
2009,21182,MTL,0,2,0,0,0,2
2009,21182,OTT,0,1,2,0,0,3
2009,21183,CGY,0,2,2,0,0,4
2009,21183,LAK,0,1,0,0,0,1
2009,21184,NJD,0,1,0,0,0,1
2009,21184,TOR,3,0,1,0,0,4
2009,21185,MTL,1,0,0,0,0,1
2009,21185,NYR,1,2,0,0,0,3
2009,21186,FLA,0,1,0,0,0,1
2009,21186,PHI,0,1,1,0,0,2
2009,21187,CAR,3,3,3,0,0,9
2009,21187,NYI,0,0,0,0,0,0
2009,21188,ATL,1,1,0,0,0,2
2009,21188,WSH,3,0,1,0,0,4
2009,21189,BOS,0,2,0,0,0,2
2009,21189,OTT,2,1,0,0,0,3
2009,21190,PIT,0,3,3,0,0,6
2009,21190,TBL,0,0,4,0,0,4
2009,21191,CHI,0,3,1,0,0,4
2009,21191,NSH,1,0,1,0,0,2
2009,21192,DAL,0,0,1,0,0,1
2009,21192,MIN,1,2,0,0,0,3
2009,21193,EDM,0,1,0,0,0,1
2009,21193,LAK,2,0,0,0,0,2
2009,21194,CGY,0,1,0,0,0,1
2009,21194,VAN,1,1,2,0,0,4
2009,21195,PHX,1,0,0,0,0,1
2009,21195,STL,1,3,1,0,0,5
2009,21196,COL,0,0,0,0,0,0
2009,21196,SJS,0,0,0,0,1,1
2009,21197,BUF,0,1,2,0,0,3
2009,21197,TOR,1,0,0,0,0,1
2009,21198,CHI,2,1,0,0,0,3
2009,21198,CBJ,0,2,1,0,1,4
2009,21199,BOS,1,2,1,1,0,5
2009,21199,MTL,0,4,0,0,0,4
2009,21200,NYR,2,0,0,0,0,2
2009,21200,PHI,0,1,0,0,0,1
2009,21201,BUF,1,3,1,0,0,5
2009,21201,CAR,0,0,1,0,0,1
2009,21202,ATL,1,0,1,0,0,2
2009,21202,FLA,0,1,2,0,0,3
2009,21203,NJD,0,2,0,0,1,3
2009,21203,OTT,1,0,1,0,0,2
2009,21204,NYI,1,0,0,0,0,1
2009,21204,PIT,1,2,3,0,0,6
2009,21205,TBL,1,0,1,0,0,2
2009,21205,WSH,1,2,1,0,0,4
2009,21206,DET,1,1,1,0,0,3
2009,21206,NSH,0,1,2,0,1,4
2009,21207,COL,0,1,1,0,0,2
2009,21207,DAL,0,0,2,0,1,3
2009,21208,LAK,0,0,0,0,0,0
2009,21208,VAN,0,1,0,0,0,1
2009,21209,PHX,2,1,1,0,0,4
2009,21209,SJS,0,0,1,0,0,1
2009,21210,MIN,2,3,3,0,0,8
2009,21210,NSH,1,1,2,0,0,4
2009,21211,CBJ,0,1,0,0,0,1
2009,21211,STL,2,1,0,0,0,3
2009,21212,CGY,0,0,1,0,0,1
2009,21212,EDM,0,2,3,0,0,5
2009,21213,ANA,1,0,2,0,1,4
2009,21213,DAL,0,1,2,0,0,3
2009,21214,CAR,1,0,1,0,0,2
2009,21214,NJD,2,0,1,0,0,3
2009,21215,NYI,1,1,0,0,0,2
2009,21215,PHI,0,3,0,0,0,3
2009,21216,CHI,1,0,3,0,0,4
2009,21216,DET,1,1,0,0,0,2
2009,21217,COL,0,0,0,0,0,0
2009,21217,VAN,0,0,0,1,0,1
2009,21218,BOS,0,0,1,0,0,1
2009,21218,BUF,4,1,1,0,0,6
2009,21219,LAK,2,1,1,0,0,4
2009,21219,SJS,1,1,1,0,0,3
2009,21220,OTT,0,2,0,0,0,2
2009,21220,TOR,1,1,3,0,0,5
2009,21221,MTL,1,0,0,0,0,1
2009,21221,PIT,1,0,2,0,0,3
2009,21222,ATL,2,3,1,0,0,6
2009,21222,TBL,1,0,1,0,0,2
2009,21223,FLA,1,2,4,0,0,7
2009,21223,WSH,1,1,2,0,0,4
2009,21224,CBJ,2,0,1,0,0,3
2009,21224,MIN,0,3,3,0,0,6
2009,21225,ANA,0,2,2,0,0,4
2009,21225,PHX,1,3,0,0,1,5
2009,21226,CGY,0,2,2,0,0,4
2009,21226,EDM,0,1,0,0,0,1
2009,21227,COL,0,0,0,0,0,0
2009,21227,STL,1,0,0,0,0,1
2009,21228,BOS,2,3,1,0,0,6
2009,21228,NYI,0,1,1,0,0,2
2009,21229,NYR,2,0,2,0,0,4
2009,21229,PHI,2,1,0,0,0,3
2009,21230,CHI,2,0,1,0,0,3
2009,21230,DET,0,0,0,0,0,0
2010,20001,BOS,0,0,1,0,0,1
2010,20001,WSH,1,1,2,0,0,4
2010,20002,MTL,1,1,1,1,0,4
2010,20002,TOR,1,1,1,0,0,3
2010,20003,COL,2,3,0,0,0,5
2010,20003,SJS,1,1,0,0,0,2
2010,20004,CGY,3,1,1,0,0,5
2010,20004,VAN,0,2,1,0,0,3
2010,20005,CAR,0,0,0,0,0,0
2010,20005,PHI,0,2,0,0,0,2
2010,20006,NYR,1,0,1,0,0,2
2010,20006,PIT,1,2,0,0,0,3
2010,20007,CHI,0,1,2,0,0,3
2010,20007,FLA,0,1,2,0,1,4
2010,20008,DET,2,1,0,0,0,3
2010,20008,STL,1,3,0,0,0,4
2010,20009,COL,1,1,1,0,0,3
2010,20009,VAN,0,0,0,0,0,0
2010,20010,BOS,3,3,1,0,0,7
2010,20010,CAR,0,1,1,0,0,2
2010,20011,BUF,1,0,0,0,0,1
2010,20011,MTL,0,1,0,1,0,2
2010,20012,NJD,0,0,2,0,0,2
2010,20012,PHI,1,2,2,0,0,5
2010,20013,NYI,1,1,1,0,0,3
2010,20013,PIT,1,0,2,0,1,4
2010,20014,NYR,0,3,2,0,0,5
2010,20014,OTT,0,1,1,0,0,2
2010,20015,TOR,0,1,3,0,0,4
2010,20015,WSH,3,3,0,0,0,6
2010,20016,ATL,2,2,2,0,0,6
2010,20016,TBL,0,2,1,0,0,3
2010,20017,CHI,1,2,1,0,0,4
2010,20017,FLA,0,0,0,0,0,0
2010,20018,CBJ,0,1,1,0,0,2
2010,20018,MIN,0,0,1,0,0,1
2010,20019,DAL,0,1,1,0,0,2
2010,20019,NSH,1,1,0,0,1,3
2010,20020,DET,2,1,0,0,0,3
2010,20020,STL,1,3,1,0,0,5
2010,20021,CGY,2,1,1,0,0,4
2010,20021,EDM,1,1,1,0,0,3
2010,20022,ANA,0,0,1,0,0,1
2010,20022,SJS,3,1,0,0,0,4
2010,20023,LAK,0,2,1,0,0,3
2010,20023,PHX,2,2,2,0,0,6
2010,20024,NJD,2,0,0,0,0,2
2010,20024,NYR,2,1,0,0,0,3
2010,20025,CBJ,1,3,1,0,0,5
2010,20025,VAN,1,1,1,0,0,3
2010,20026,OTT,0,2,0,0,0,2
2010,20026,TOR,0,0,1,0,0,1
2010,20027,PHI,0,4,1,1,0,6
2010,20027,WSH,0,3,2,0,0,5
2010,20028,CAR,1,0,0,0,1,2
2010,20028,TBL,0,1,0,0,0,1
2010,20029,ANA,0,3,0,0,0,3
2010,20029,MIN,0,0,3,1,0,4
2010,20030,CGY,1,2,1,0,0,4
2010,20030,MTL,2,1,0,0,0,3
2010,20031,DAL,1,2,1,0,0,4
2010,20031,EDM,1,2,1,0,1,5
2010,20032,LAK,1,3,2,0,0,6
2010,20032,SJS,0,2,2,0,0,4
2010,20033,PHX,1,1,1,0,0,3
2010,20033,PIT,0,0,0,0,0,0
2010,20034,MTL,0,1,0,0,0,1
2010,20034,VAN,3,2,2,0,0,7
2010,20035,ANA,0,3,3,0,0,6
2010,20035,BOS,1,0,0,0,0,1
2010,20036,BUF,0,0,2,0,0,2
2010,20036,PHX,0,0,1,0,0,1
2010,20037,NYI,0,1,1,0,0,2
2010,20037,OTT,1,1,0,1,0,3
2010,20038,PHI,1,2,1,0,0,4
2010,20038,PIT,2,2,1,0,0,5
2010,20039,NYR,0,2,2,0,0,4
2010,20039,WSH,1,0,2,0,0,3
2010,20040,NJD,1,1,1,0,1,4
2010,20040,TBL,0,1,2,0,0,3
2010,20041,CHI,0,1,1,0,0,2
2010,20041,DET,0,3,0,0,0,3
2010,20042,ATL,2,1,1,0,0,4
2010,20042,STL,1,0,1,0,0,2
2010,20043,COL,0,1,1,0,0,2
2010,20043,NSH,0,1,2,0,0,3
2010,20044,CGY,0,1,2,0,1,4
2010,20044,EDM,2,0,1,0,0,3
2010,20045,LAK,3,1,2,0,0,6
2010,20045,MIN,0,2,1,0,0,3
2010,20046,CBJ,1,1,1,0,0,3
2010,20046,SJS,0,4,2,0,0,6
2010,20047,CAR,3,1,3,0,0,7
2010,20047,FLA,0,1,1,0,0,2
2010,20048,CGY,0,1,1,0,0,2
2010,20048,DAL,1,2,2,0,0,5
2010,20049,BOS,0,0,3,0,1,4
2010,20049,NYI,0,3,0,0,0,3
2010,20050,PIT,2,2,1,0,0,5
2010,20050,TOR,0,1,1,0,0,2
2010,20051,ATL,2,0,0,0,0,2
2010,20051,OTT,2,1,1,0,0,4
2010,20052,ANA,0,0,2,0,1,3
2010,20052,PHI,1,1,0,0,0,2
2010,20053,FLA,0,1,1,0,0,2
2010,20053,NJD,0,2,1,0,0,3
2010,20054,DET,1,1,1,0,0,3
2010,20054,WSH,1,0,1,0,0,2
2010,20055,CAR,0,2,0,0,0,2
2010,20055,TBL,0,2,3,0,0,5
2010,20056,LAK,1,1,0,0,0,2
2010,20056,STL,0,0,1,0,0,1
2010,20057,BUF,0,0,1,0,0,1
2010,20057,NSH,0,0,0,0,0,0
2010,20058,CHI,1,2,0,0,1,4
2010,20058,COL,0,3,0,0,0,3
2010,20059,CBJ,1,0,1,0,0,2
2010,20059,PHX,0,0,0,0,0,0
2010,20060,MTL,0,1,1,0,0,2
2010,20060,EDM,1,2,0,0,0,3
2010,20061,MIN,1,1,0,0,0,2
2010,20061,SJS,0,3,1,0,0,4
2010,20062,ANA,0,0,0,0,0,0
2010,20062,NYR,0,0,3,0,0,3
2010,20063,DAL,1,0,2,0,0,3
2010,20063,VAN,1,1,1,0,1,4
2010,20064,BOS,0,2,1,0,0,3
2010,20064,COL,2,2,0,0,0,4
2010,20065,LAK,0,1,1,0,0,2
2010,20065,NYI,0,0,1,0,0,1
2010,20066,NYR,2,1,4,0,0,7
2010,20066,TOR,1,1,0,0,0,2
2010,20067,NJD,0,1,1,0,1,3
2010,20067,WSH,2,0,0,0,0,2
2010,20068,OTT,1,0,0,0,0,1
2010,20068,PIT,1,2,1,0,0,4
2010,20069,FLA,1,1,0,0,0,2
2010,20069,TBL,1,0,2,0,0,3
2010,20070,EDM,4,2,0,0,0,6
2010,20070,NSH,0,1,0,0,0,1
2010,20071,CGY,5,0,0,0,0,5
2010,20071,CHI,1,3,1,1,0,6
2010,20072,PHX,0,0,0,0,1,1
2010,20072,SJS,0,0,0,0,0,0
2010,20073,BUF,1,4,1,0,0,6
2010,20073,DET,1,0,1,0,0,2
2010,20074,CGY,1,0,0,0,0,1
2010,20074,CBJ,0,2,0,0,0,2
2010,20075,COL,2,2,0,0,0,4
2010,20075,TOR,0,1,0,0,0,1
2010,20076,LAK,1,1,0,0,0,2
2010,20076,NYR,2,1,1,0,0,4
2010,20077,CHI,2,1,1,0,0,4
2010,20077,EDM,1,0,2,0,0,3
2010,20078,DAL,4,1,1,0,0,6
2010,20078,NSH,0,0,0,0,0,0
2010,20079,ANA,2,1,0,0,0,3
2010,20079,MIN,0,1,1,0,0,2
2010,20080,SJS,1,0,0,0,0,1
2010,20080,WSH,1,2,1,0,0,4
2010,20081,CAR,0,0,0,0,0,0
2010,20081,PIT,0,0,0,0,0,0
2010,20082,MTL,1,0,1,0,0,2
2010,20082,COL,0,2,1,0,0,3
2010,20083,OTT,2,3,2,0,0,7
2010,20083,TBL,0,1,0,0,0,1
2010,20084,DET,0,2,3,0,0,5
2010,20084,LAK,1,0,1,0,0,2
2010,20085,CHI,0,2,1,0,0,3
2010,20085,NSH,0,1,0,0,0,1
2010,20086,PHX,0,1,1,1,0,3
2010,20086,STL,0,2,0,0,0,2
2010,20087,ATL,0,1,3,0,0,4
2010,20087,NJD,0,1,1,0,0,2
2010,20088,BUF,2,2,2,0,0,6
2010,20088,NYI,0,2,1,0,0,3
2010,20089,FLA,0,2,2,0,0,4
2010,20089,PHI,1,1,0,0,0,2
2010,20090,BOS,1,2,0,0,0,3
2010,20090,DAL,0,0,0,0,0,0
2010,20091,CGY,2,3,0,0,0,5
2010,20091,VAN,0,0,3,0,0,3
2010,20092,EDM,0,3,2,0,0,5
2010,20092,MIN,0,1,1,0,0,2
2010,20093,ATL,2,1,1,0,0,4
2010,20093,BUF,0,1,1,0,0,2
2010,20094,NYR,1,2,1,0,0,4
2010,20094,TOR,0,1,0,0,0,1
2010,20095,MTL,1,0,0,0,0,1
2010,20095,OTT,1,1,1,0,0,3
2010,20096,CAR,0,0,0,0,0,0
2010,20096,NJD,0,0,2,0,0,2
2010,20097,NYI,1,0,0,0,0,1
2010,20097,SJS,0,2,2,0,0,4
2010,20098,NSH,0,2,0,0,0,2
2010,20098,WSH,2,0,0,0,1,3
2010,20099,COL,0,0,3,0,1,4
2010,20099,DET,1,1,1,0,0,3
2010,20100,CBJ,1,1,2,0,0,4
2010,20100,LAK,1,0,0,0,0,1
2010,20101,PIT,2,1,1,0,0,4
2010,20101,TBL,0,1,0,0,0,1
2010,20102,CHI,0,2,1,0,0,3
2010,20102,DAL,0,3,1,0,0,4
2010,20103,BOS,0,1,0,0,0,1
2010,20103,PHX,1,3,0,0,0,4
2010,20104,MIN,1,0,0,0,0,1
2010,20104,VAN,0,1,1,0,0,2
2010,20105,ANA,0,0,0,0,0,0
2010,20105,STL,1,2,2,0,0,5
2010,20106,NYR,2,0,1,0,0,3
2010,20106,SJS,2,3,2,0,0,7
2010,20107,DAL,1,0,0,0,0,1
2010,20107,LAK,0,3,1,0,0,4
2010,20108,EDM,0,1,1,0,0,2
2010,20108,VAN,1,0,0,0,0,1
2010,20109,PIT,2,2,1,0,0,5
2010,20109,STL,0,1,0,0,0,1
2010,20110,ATL,0,0,1,0,0,1
2010,20110,MTL,1,0,0,0,1,2
2010,20111,CGY,3,1,2,0,0,6
2010,20111,CBJ,1,2,0,0,0,3
2010,20112,BOS,0,2,1,0,0,3
2010,20112,NSH,1,1,0,0,0,2
2010,20113,CAR,0,1,2,0,0,3
2010,20113,NYI,1,2,0,0,1,4
2010,20114,BUF,5,0,0,0,0,5
2010,20114,FLA,1,0,1,0,0,2
2010,20115,COL,0,2,0,0,0,2
2010,20115,MIN,1,0,1,0,1,3
2010,20116,CHI,1,1,0,0,0,2
2010,20116,VAN,0,1,2,0,0,3
2010,20117,ANA,0,1,1,0,0,2
2010,20117,DAL,1,2,1,0,0,4
2010,20118,MTL,2,1,2,0,0,5
2010,20118,NYI,0,0,1,0,0,1
2010,20119,NJD,2,0,2,0,0,4
2010,20119,NYR,0,2,0,0,0,2
2010,20120,BOS,1,2,0,0,0,3
2010,20120,PHI,1,2,0,0,1,4
2010,20121,ATL,2,0,2,0,0,4
2010,20121,WSH,2,3,0,0,0,5
2010,20122,NSH,3,0,2,1,0,6
2010,20122,OTT,0,0,5,0,0,5
2010,20123,SJS,0,1,1,0,0,2
2010,20123,TBL,2,1,2,0,0,5
2010,20124,CBJ,2,2,0,0,0,4
2010,20124,EDM,1,2,3,0,0,6
2010,20125,DET,1,1,0,0,0,2
2010,20125,PHX,1,0,1,1,0,3
2010,20126,DAL,1,0,3,0,0,4
2010,20126,LAK,2,2,0,1,0,5
2010,20127,FLA,2,0,0,0,0,2
2010,20127,PIT,0,0,2,0,1,3
2010,20128,MIN,0,1,0,0,0,1
2010,20128,STL,1,1,1,0,0,3
2010,20129,CAR,2,1,1,0,0,4
2010,20129,COL,2,2,1,0,0,5
2010,20130,MTL,1,3,0,1,0,5
2010,20130,NYR,3,1,0,0,0,4
2010,20131,BOS,0,1,2,0,1,4
2010,20131,OTT,0,1,2,0,0,3
2010,20132,NYI,1,0,1,0,0,2
2010,20132,WSH,0,0,2,1,0,3
2010,20133,FLA,1,0,0,0,0,1
2010,20133,PHI,1,2,2,0,0,5
2010,20134,ATL,0,2,1,0,0,3
2010,20134,SJS,2,2,0,0,0,4
2010,20135,TOR,0,1,0,0,0,1
2010,20135,VAN,2,0,1,0,0,3
2010,20136,NJD,1,1,2,0,0,4
2010,20136,PIT,0,0,1,0,0,1
2010,20137,BUF,0,1,1,0,1,3
2010,20137,TBL,1,0,1,0,0,2
2010,20138,DAL,0,2,2,0,0,4
2010,20138,STL,0,0,1,0,0,1
2010,20139,CAR,1,1,0,0,0,2
2010,20139,MIN,1,1,0,1,0,3
2010,20140,CHI,0,2,0,0,0,2
2010,20140,NSH,0,0,0,0,0,0
2010,20141,COL,0,1,2,0,0,3
2010,20141,DET,0,1,0,0,0,1
2010,20142,LAK,0,2,3,0,0,5
2010,20142,PHX,1,1,1,0,0,3
2010,20143,CGY,1,3,1,0,0,5
2010,20143,EDM,1,1,0,0,0,2
2010,20144,ANA,1,1,2,0,0,4
2010,20144,CBJ,0,4,2,0,0,6
2010,20145,PHI,1,0,0,0,0,1
2010,20145,SJS,1,2,1,0,0,4
2010,20146,CBJ,0,1,1,0,0,2
2010,20146,LAK,2,2,2,0,0,6
2010,20147,EDM,0,0,0,0,0,0
2010,20147,VAN,1,1,0,0,0,2
2010,20148,NYR,2,2,1,0,0,5
2010,20148,PHX,0,2,0,0,0,2
2010,20149,MTL,1,0,1,1,0,3
2010,20149,NYI,0,1,1,0,0,2
2010,20150,CHI,2,0,1,0,0,3
2010,20150,MIN,0,0,1,0,0,1
2010,20151,ANA,1,1,1,0,0,3
2010,20151,TOR,2,1,3,0,0,6
2010,20152,PHI,0,2,0,0,0,2
2010,20152,WSH,0,2,2,0,0,4
2010,20153,COL,1,0,2,0,0,3
2010,20153,EDM,0,0,0,0,0,0
2010,20154,DET,1,0,4,0,0,5
2010,20154,VAN,2,0,2,0,0,4
2010,20155,BUF,2,0,2,0,0,4
2010,20155,NJD,0,1,0,0,0,1
2010,20156,NYI,1,1,1,0,0,3
2010,20156,NYR,1,0,0,0,0,1
2010,20157,CAR,1,0,1,0,0,2
2010,20157,STL,3,1,1,0,0,5
2010,20158,CBJ,1,0,0,0,0,1
2010,20158,PHX,0,2,2,0,0,4
2010,20159,MTL,0,0,1,0,0,1
2010,20159,PIT,1,3,2,0,0,6
2010,20160,FLA,1,1,1,0,0,3
2010,20160,OTT,1,3,0,0,0,4
2010,20161,MIN,0,3,0,0,0,3
2010,20161,NSH,2,1,1,0,0,4
2010,20162,DAL,0,1,2,1,0,4
2010,20162,TOR,0,1,2,0,0,3
2010,20163,CGY,2,0,0,0,0,2
2010,20163,COL,2,0,1,0,0,3
2010,20164,LAK,0,1,0,0,0,1
2010,20164,SJS,0,1,0,0,1,2
2010,20165,BOS,0,1,0,0,0,1
2010,20165,NJD,1,0,1,0,0,2
2010,20166,ATL,0,0,3,0,0,3
2010,20166,WSH,2,1,1,0,0,4
2010,20167,OTT,0,0,2,0,0,2
2010,20167,TBL,1,2,2,0,0,5
2010,20168,PHX,0,1,1,0,0,2
2010,20168,STL,0,0,0,0,0,0
2010,20169,CHI,0,0,0,0,0,0
2010,20169,NSH,0,1,1,0,0,2
2010,20170,DET,0,2,3,0,0,5
2010,20170,EDM,3,2,0,0,1,6
2010,20171,LAK,1,0,0,0,0,1
2010,20171,VAN,1,0,0,0,1,2
2010,20172,NYI,1,2,0,1,0,4
2010,20172,WSH,1,2,0,0,0,3
2010,20173,CBJ,1,2,0,0,0,3
2010,20173,PIT,0,1,2,0,1,4
2010,20174,BUF,1,1,0,1,0,3
2010,20174,TOR,1,0,1,0,0,2
2010,20175,MIN,1,2,0,0,0,3
2010,20175,NYR,0,1,1,0,0,2
2010,20176,MTL,0,2,0,0,0,2
2010,20176,CHI,1,1,1,0,0,3
2010,20177,DAL,2,2,1,0,0,5
2010,20177,FLA,3,1,1,0,1,6
2010,20178,ANA,1,3,3,0,0,7
2010,20178,VAN,2,0,0,0,0,2
2010,20179,COL,0,0,1,0,0,1
2010,20179,SJS,0,1,2,0,0,3
2010,20180,BOS,0,0,2,0,0,2
2010,20180,EDM,0,0,0,0,0,0
2010,20181,CAR,0,1,0,0,0,1
2010,20181,PHI,3,1,2,0,0,6
2010,20182,ATL,1,1,1,0,0,3
2010,20182,OTT,0,0,1,0,0,1
2010,20183,NJD,0,1,0,0,1,2
2010,20183,TBL,0,0,1,0,0,1
2010,20184,MTL,0,3,1,0,1,5
2010,20184,TOR,0,2,2,0,0,4
2010,20185,BUF,0,0,0,0,0,0
2010,20185,NYI,1,3,1,0,0,5
2010,20186,MIN,2,0,0,0,0,2
2010,20186,PIT,1,0,0,0,0,1
2010,20187,FLA,2,0,2,0,0,4
2010,20187,STL,0,0,0,0,0,0
2010,20188,DAL,1,1,0,0,0,2
2010,20188,NSH,1,0,3,0,0,4
2010,20189,ANA,0,1,1,0,0,2
2010,20189,PHX,1,0,1,0,1,3
2010,20190,CGY,0,1,0,0,0,1
2010,20190,DET,0,2,1,0,0,3
2010,20191,BOS,0,0,0,0,0,0
2010,20191,NYR,0,1,0,0,0,1
2010,20192,CAR,0,1,0,0,0,1
2010,20192,SJS,0,3,2,0,0,5
2010,20193,CBJ,0,2,2,1,0,5
2010,20193,WSH,1,0,3,0,0,4
2010,20194,COL,0,0,0,0,0,0
2010,20194,VAN,1,1,1,0,0,3
2010,20195,EDM,1,0,0,0,0,1
2010,20195,NYI,1,2,0,0,0,3
2010,20196,PHI,2,3,1,0,0,6
2010,20196,TBL,0,1,1,0,0,2
2010,20197,LAK,1,1,3,0,0,5
2010,20197,PHX,1,2,0,0,0,3
2010,20198,BOS,0,0,0,0,0,0
2010,20198,DET,2,0,0,0,0,2
2010,20199,TBL,0,1,0,1,0,2
2010,20199,TOR,0,0,1,0,0,1
2010,20200,ATL,2,1,2,0,0,5
2010,20200,MTL,0,2,2,0,0,4
2010,20201,NYR,0,0,1,0,0,1
2010,20201,VAN,1,0,3,0,0,4
2010,20202,ANA,1,1,1,0,0,3
2010,20202,PIT,0,2,2,0,0,4
2010,20203,BUF,1,1,1,0,0,3
2010,20203,NYI,0,0,0,0,0,0
2010,20204,NJD,0,1,2,0,0,3
2010,20204,WSH,1,0,1,0,0,2
2010,20205,CBJ,1,1,0,0,0,2
2010,20205,SJS,1,1,0,0,1,3
2010,20206,CAR,0,0,0,0,0,0
2010,20206,FLA,0,0,3,0,0,3
2010,20207,CGY,0,1,1,1,0,3
2010,20207,DAL,0,0,2,0,0,2
2010,20208,COL,1,0,3,0,0,4
2010,20208,PHX,0,0,1,0,0,1
2010,20209,BOS,0,0,1,0,0,1
2010,20209,MTL,1,0,0,0,1,2
2010,20210,ATL,0,2,1,0,0,3
2010,20210,CBJ,2,2,0,0,0,4
2010,20211,OTT,1,1,0,1,0,3
2010,20211,TBL,1,1,0,0,0,2
2010,20212,DET,0,0,1,0,1,2
2010,20212,SJS,0,1,0,0,0,1
2010,20213,CGY,1,0,0,1,0,2
2010,20213,STL,0,0,1,0,0,1
2010,20214,MIN,0,2,0,0,0,2
2010,20214,VAN,1,3,1,0,0,5
2010,20215,CHI,0,1,0,0,0,1
2010,20215,PHX,2,1,0,0,0,3
2010,20216,EDM,0,1,1,0,0,2
2010,20216,NYR,1,2,1,0,0,4
2010,20217,ANA,1,0,3,0,0,4
2010,20217,NSH,0,0,0,0,0,0
2010,20218,LAK,1,0,4,0,0,5
2010,20218,PIT,1,1,0,0,0,2
2010,20219,NJD,0,2,0,0,0,2
2010,20219,NYI,1,0,0,0,0,1
2010,20220,CAR,2,0,0,0,0,2
2010,20220,TOR,0,2,1,0,0,3
2010,20221,BUF,0,1,1,0,0,2
2010,20221,PHI,1,2,2,0,0,5
2010,20222,FLA,0,0,1,0,0,1
2010,20222,WSH,1,1,2,0,0,4
2010,20223,DAL,0,1,1,0,0,2
2010,20223,VAN,0,0,1,0,0,1
2010,20224,CHI,2,1,0,0,0,3
2010,20224,COL,1,2,0,0,1,4
2010,20225,LAK,0,0,1,0,0,1
2010,20225,NSH,0,1,2,0,0,3
2010,20226,BOS,2,2,0,0,0,4
2010,20226,BUF,0,1,1,0,0,2
2010,20227,DET,0,0,1,0,0,1
2010,20227,TOR,2,1,2,0,0,5
2010,20228,MTL,0,1,0,0,0,1
2010,20228,TBL,2,1,0,0,0,3
2010,20229,NJD,0,1,2,0,0,3
2010,20229,OTT,1,1,0,0,0,2
2010,20230,ATL,1,1,1,0,0,3
2010,20230,NYI,3,2,1,0,0,6
2010,20231,PHI,0,1,0,0,1,2
2010,20231,STL,0,0,1,0,0,1
2010,20232,FLA,0,3,1,0,0,4
2010,20232,WSH,1,1,5,0,0,7
2010,20233,CAR,1,0,1,0,0,2
2010,20233,CBJ,0,0,3,0,0,3
2010,20234,DAL,0,2,0,0,0,2
2010,20234,MIN,2,1,0,0,0,3
2010,20235,CGY,1,1,1,0,0,3
2010,20235,NYR,1,0,0,0,0,1
2010,20236,ANA,1,2,1,0,0,4
2010,20236,PHX,0,0,3,0,0,3
2010,20237,PIT,0,0,0,0,0,0
2010,20237,SJS,2,2,1,0,0,5
2010,20238,ATL,0,0,2,0,1,3
2010,20238,STL,0,1,1,0,0,2
2010,20239,COL,1,1,1,0,0,3
2010,20239,EDM,3,0,2,0,0,5
2010,20240,CHI,0,1,3,0,0,4
2010,20240,LAK,0,1,0,0,0,1
2010,20241,BOS,0,1,2,0,0,3
2010,20241,PIT,0,0,0,0,0,0
2010,20242,MIN,1,3,1,0,0,5
2010,20242,TOR,1,0,1,0,0,2
2010,20243,CGY,1,0,0,0,0,1
2010,20243,MTL,0,0,0,0,0,0
2010,20244,EDM,2,0,1,0,0,3
2010,20244,OTT,1,1,1,0,1,4
2010,20245,STL,4,1,1,0,0,6
2010,20245,VAN,0,0,1,0,0,1
2010,20246,NSH,1,1,1,0,0,3
2010,20246,SJS,1,1,2,0,0,4
2010,20247,BUF,1,1,1,0,0,3
2010,20247,EDM,0,1,0,0,0,1
2010,20248,ANA,0,1,0,0,0,1
2010,20248,NJD,1,2,0,0,0,3
2010,20249,NYI,3,0,1,0,0,4
2010,20249,WSH,2,2,0,0,1,5
2010,20250,CAR,0,1,1,0,0,2
2010,20250,LAK,1,1,3,0,0,5
2010,20251,CBJ,0,1,0,0,0,1
2010,20251,DET,4,2,3,0,0,9
2010,20252,CHI,1,0,1,0,1,3
2010,20252,COL,1,1,0,0,0,2
2010,20253,BOS,0,0,0,0,0,0
2010,20253,FLA,0,0,0,0,1,1
2010,20254,ATL,1,3,1,0,0,5
2010,20254,NYR,1,1,1,0,0,3
2010,20255,OTT,0,1,0,0,0,1
2010,20255,PHI,0,2,3,0,0,5
2010,20256,NJD,0,2,2,0,0,4
2010,20256,PIT,1,0,0,0,0,1
2010,20257,MIN,1,2,0,0,0,3
2010,20257,TBL,0,1,2,0,1,4
2010,20258,DET,1,0,2,0,0,3
2010,20258,VAN,0,1,0,0,0,1
2010,20259,NSH,0,1,2,0,0,3
2010,20259,STL,1,0,0,0,0,1
2010,20260,MTL,0,1,3,0,0,4
2010,20260,PHX,0,1,1,0,0,2
2010,20261,DAL,0,0,2,0,1,3
2010,20261,SJS,0,2,0,0,0,2
2010,20262,MIN,0,1,0,0,0,1
2010,20262,WSH,0,1,2,0,0,3
2010,20263,CAR,0,2,1,0,0,3
2010,20263,NYI,3,0,0,1,0,4
2010,20264,ANA,1,1,0,0,0,2
2010,20264,CBJ,1,1,0,0,1,3
2010,20265,BUF,1,0,0,0,1,2
2010,20265,CGY,1,0,0,0,0,1
2010,20266,ATL,0,4,3,0,0,7
2010,20266,LAK,0,0,0,0,0,0
2010,20267,CHI,2,1,0,0,0,3
2010,20267,TOR,0,1,1,0,0,2
2010,20268,CGY,3,0,2,0,0,5
2010,20268,TOR,1,1,0,0,0,2
2010,20269,NYR,0,1,0,0,1,2
2010,20269,OTT,0,1,0,0,0,1
2010,20270,NJD,1,3,1,0,0,5
2010,20270,WSH,2,0,0,0,0,2
2010,20271,BUF,1,1,1,0,0,3
2010,20271,PHI,0,0,2,0,0,2
2010,20272,FLA,0,3,1,0,1,5
2010,20272,NYI,2,0,2,0,0,4
2010,20273,ANA,0,1,3,0,0,4
2010,20273,DET,2,0,5,0,0,7
2010,20274,BOS,1,2,2,0,0,5
2010,20274,PIT,2,1,2,1,0,6
2010,20275,LAK,0,0,1,0,1,2
2010,20275,TBL,0,0,1,0,0,1
2010,20276,SJS,0,2,1,0,0,3
2010,20276,STL,1,0,0,0,0,1
2010,20277,MTL,0,0,0,0,0,0
2010,20277,NSH,1,0,1,0,0,2
2010,20278,DAL,0,1,1,0,0,2
2010,20278,PHX,0,2,1,0,0,3
2010,20279,COL,0,0,2,0,0,2
2010,20279,VAN,3,1,4,0,0,8
2010,20280,CAR,2,2,0,0,1,5
2010,20280,MIN,0,3,1,0,0,4
2010,20281,ATL,1,1,1,0,0,3
2010,20281,EDM,0,2,0,0,0,2
2010,20282,CHI,1,2,0,1,0,4
2010,20282,SJS,1,2,0,0,0,3
2010,20283,BOS,0,1,0,0,0,1
2010,20283,NYI,1,1,2,0,0,4
2010,20284,NJD,0,1,1,0,0,2
2010,20284,PHI,1,1,1,0,0,3
2010,20285,CBJ,0,1,1,0,1,3
2010,20285,EDM,0,1,1,0,0,2
2010,20286,ANA,1,0,1,0,0,2
2010,20286,PIT,2,1,2,0,0,5
2010,20287,FLA,0,2,1,0,0,3
2010,20287,LAK,0,1,2,0,1,4
2010,20288,PHX,1,0,0,0,0,1
2010,20288,TBL,2,1,1,0,0,4
2010,20289,NYR,1,0,1,0,0,2
2010,20289,WSH,1,1,2,0,0,4
2010,20290,MTL,1,0,1,0,1,3
2010,20290,CAR,0,2,0,0,0,2
2010,20291,OTT,1,2,0,0,0,3
2010,20291,TOR,1,1,0,0,0,2
2010,20292,NSH,2,2,0,0,0,4
2010,20292,SJS,1,1,1,0,0,3
2010,20293,CGY,0,2,0,0,0,2
2010,20293,COL,1,2,0,0,0,3
2010,20294,BUF,1,0,1,0,0,2
2010,20294,FLA,1,1,4,0,0,6
2010,20295,DAL,1,1,1,0,0,3
2010,20295,DET,0,1,0,0,0,1
2010,20296,MIN,0,0,2,0,0,2
2010,20296,PHX,0,1,2,0,0,3
2010,20297,COL,2,2,0,0,0,4
2010,20297,EDM,1,2,3,0,0,6
2010,20298,LAK,1,0,1,0,0,2
2010,20298,PHI,0,2,1,0,0,3
2010,20299,CAR,0,2,3,0,1,6
2010,20299,TOR,3,0,2,0,0,5
2010,20300,ATL,0,2,1,0,0,3
2010,20300,BOS,2,1,0,0,1,4
2010,20301,OTT,1,1,4,0,0,6
2010,20301,PIT,1,0,1,0,0,2
2010,20302,PHX,1,1,0,0,0,2
2010,20302,STL,1,0,1,1,0,3
2010,20303,NSH,1,0,1,0,1,3
2010,20303,NJD,1,0,1,0,0,2
2010,20304,CBJ,2,2,0,0,0,4
2010,20304,DAL,0,1,0,0,0,1
2010,20305,CGY,0,1,0,0,0,1
2010,20305,CHI,1,5,1,0,0,7
2010,20306,ANA,2,1,0,1,0,4
2010,20306,TBL,0,2,1,0,0,3
2010,20307,MTL,0,2,1,0,0,3
2010,20307,WSH,1,0,1,0,0,2
2010,20308,BOS,0,1,0,1,0,2
2010,20308,BUF,1,0,0,0,0,1
2010,20309,DET,0,1,0,0,0,1
2010,20309,FLA,0,0,1,1,0,2
2010,20310,MIN,1,0,2,0,0,3
2010,20310,NYI,0,2,0,0,0,2
2010,20311,COL,2,0,0,0,0,2
2010,20311,VAN,0,1,4,0,0,5
2010,20312,PHI,1,1,1,0,0,3
2010,20312,SJS,1,2,3,0,0,6
2010,20313,CGY,1,1,3,0,0,5
2010,20313,LAK,0,2,0,0,0,2
2010,20314,TOR,0,1,0,0,1,2
2010,20314,WSH,1,0,0,0,0,1
2010,20315,MTL,0,0,2,0,0,2
2010,20315,DET,2,0,0,0,1,3
2010,20316,BUF,1,0,2,0,0,3
2010,20316,OTT,0,2,3,0,0,5
2010,20317,FLA,0,2,1,0,0,3
2010,20317,NYR,1,0,1,0,0,2
2010,20318,CAR,0,2,1,0,0,3
2010,20318,TBL,1,0,0,0,0,1
2010,20319,ATL,0,0,2,0,0,2
2010,20319,PIT,1,2,0,0,0,3
2010,20320,NYI,1,0,0,0,0,1
2010,20320,STL,1,1,2,0,0,4
2010,20321,CBJ,2,1,0,0,0,3
2010,20321,NSH,1,2,0,0,1,4
2010,20322,DAL,3,0,2,0,0,5
2010,20322,NJD,1,1,1,0,0,3
2010,20323,PHI,0,1,0,0,0,1
2010,20323,PHX,0,1,2,0,0,3
2010,20324,CHI,3,1,1,0,0,5
2010,20324,EDM,1,0,1,0,0,2
2010,20325,ANA,0,2,0,0,0,2
2010,20325,SJS,0,2,1,0,0,3
2010,20326,ATL,0,0,3,0,0,3
2010,20326,TBL,0,2,1,1,0,4
2010,20327,CHI,0,0,1,0,0,1
2010,20327,VAN,0,0,0,0,0,0
2010,20328,DET,0,1,0,0,0,1
2010,20328,NSH,1,1,1,0,0,3
2010,20329,NYI,0,3,0,1,0,4
2010,20329,TOR,0,1,2,0,0,3
2010,20330,CBJ,2,1,1,0,0,4
2010,20330,NYR,3,4,0,0,0,7
2010,20331,OTT,1,0,2,1,0,4
2010,20331,WSH,2,1,0,0,0,3
2010,20332,FLA,1,1,0,0,0,2
2010,20332,PIT,0,0,2,1,0,3
2010,20333,BOS,1,2,1,0,0,4
2010,20333,STL,1,1,0,0,0,2
2010,20334,CAR,0,0,0,0,0,0
2010,20334,DAL,1,0,1,0,0,2
2010,20335,COL,2,3,0,0,0,5
2010,20335,PHI,1,1,2,0,0,4
2010,20336,EDM,3,1,0,0,0,4
2010,20336,PHX,0,0,0,0,0,0
2010,20337,ANA,2,0,0,0,1,3
2010,20337,CGY,1,0,1,0,0,2
2010,20338,MTL,1,1,3,0,0,5
2010,20338,CBJ,2,1,0,0,0,3
2010,20339,NJD,1,1,1,0,0,3
2010,20339,OTT,1,0,0,0,0,1
2010,20340,NYI,1,0,0,0,0,1
2010,20340,PHI,0,1,1,0,0,2
2010,20341,BUF,0,0,0,0,0,0
2010,20341,WSH,1,0,1,0,0,2
2010,20342,TBL,2,1,0,0,0,3
2010,20342,TOR,2,2,0,0,0,4
2010,20343,MTL,0,0,1,0,0,1
2010,20343,PIT,1,2,0,0,0,3
2010,20344,FLA,0,0,1,0,0,1
2010,20344,NYR,0,1,0,0,1,2
2010,20345,ATL,1,1,0,0,0,2
2010,20345,DET,0,0,0,0,0,0
2010,20346,BOS,1,0,0,0,1,2
2010,20346,MIN,0,1,0,0,0,1
2010,20347,DAL,2,0,1,0,0,3
2010,20347,STL,2,0,1,0,1,4
2010,20348,COL,0,3,0,0,0,3
2010,20348,NSH,2,1,0,1,0,4
2010,20349,CGY,0,1,1,0,0,2
2010,20349,PHX,0,0,1,0,0,1
2010,20350,EDM,1,0,0,0,0,1
2010,20350,LAK,0,1,2,0,0,3
2010,20351,ANA,0,1,2,0,0,3
2010,20351,CAR,1,0,1,0,0,2
2010,20352,CHI,1,3,3,0,0,7
2010,20352,SJS,0,0,2,0,0,2
2010,20353,CBJ,1,0,0,0,0,1
2010,20353,OTT,1,0,1,0,0,2
2010,20354,LAK,0,1,0,0,0,1
2010,20354,VAN,1,0,3,0,0,4
2010,20355,BOS,0,0,1,0,0,1
2010,20355,NJD,0,1,0,0,1,2
2010,20356,BUF,1,1,2,0,0,4
2010,20356,PHI,2,0,0,0,0,2
2010,20357,NYI,1,0,2,0,0,3
2010,20357,PIT,1,1,0,0,0,2
2010,20358,COL,1,2,0,0,0,3
2010,20358,MIN,1,2,2,0,0,5
2010,20359,ANA,1,2,0,0,0,3
2010,20359,CHI,0,0,0,0,0,0
2010,20360,ATL,0,1,5,0,0,6
2010,20360,CAR,1,3,0,0,0,4
2010,20361,NYR,0,0,1,0,0,1
2010,20361,TBL,2,2,1,0,0,5
2010,20362,FLA,2,1,1,0,0,4
2010,20362,TOR,1,2,3,0,0,6
2010,20363,CGY,2,0,1,0,0,3
2010,20363,DET,0,0,0,0,0,0
2010,20364,NSH,0,0,1,0,0,1
2010,20364,STL,0,1,2,0,0,3
2010,20365,EDM,0,1,3,0,0,4
2010,20365,SJS,1,0,3,0,1,5
2010,20366,DAL,0,0,2,0,0,2
2010,20366,PHX,1,3,1,0,0,5
2010,20367,NJD,0,2,4,0,0,6
2010,20367,NYI,1,0,0,0,0,1
2010,20368,BOS,0,2,1,0,1,4
2010,20368,OTT,2,0,1,0,0,3
2010,20369,BUF,0,0,5,0,0,5
2010,20369,CAR,1,0,0,0,0,1
2010,20370,MTL,0,2,1,0,0,3
2010,20370,WSH,2,0,1,0,1,4
2010,20371,ATL,0,1,0,0,0,1
2010,20371,PHI,0,0,0,0,0,0
2010,20372,CGY,0,1,2,0,1,4
2010,20372,CBJ,0,3,0,0,0,3
2010,20373,NYR,1,1,1,0,0,3
2010,20373,PIT,3,1,4,0,0,8
2010,20374,DET,0,1,2,0,1,4
2010,20374,STL,2,0,1,0,0,3
2010,20375,FLA,0,1,0,0,0,1
2010,20375,NSH,1,0,3,0,0,4
2010,20376,DAL,0,2,1,1,0,4
2010,20376,TBL,0,1,2,0,0,3
2010,20377,COL,2,0,0,0,0,2
2010,20377,MIN,0,1,1,0,1,3
2010,20378,EDM,1,2,0,0,0,3
2010,20378,VAN,5,1,1,0,0,7
2010,20379,CHI,0,0,1,0,0,1
2010,20379,LAK,0,1,0,0,1,2
2010,20380,ANA,0,1,1,0,0,2
2010,20380,PHX,0,0,2,1,0,3
2010,20381,SJS,1,1,2,0,0,4
2010,20381,VAN,1,0,1,0,0,2
2010,20382,BUF,0,1,2,0,0,3
2010,20382,TOR,0,0,0,0,0,0
2010,20383,NYR,0,2,0,0,0,2
2010,20383,PIT,0,2,3,0,0,5
2010,20384,CAR,1,0,1,0,0,2
2010,20384,WSH,2,1,0,0,0,3
2010,20385,ATL,2,1,1,0,0,4
2010,20385,FLA,2,1,0,0,0,3
2010,20386,CBJ,2,0,3,0,0,5
2010,20386,STL,1,1,0,0,0,2
2010,20387,COL,1,1,1,0,0,3
2010,20387,TBL,0,0,0,0,0,0
2010,20388,DAL,1,0,0,0,0,1
2010,20388,DET,1,2,1,0,0,4
2010,20389,CGY,0,2,3,0,0,5
2010,20389,NSH,0,0,0,0,0,0
2010,20390,MTL,0,0,0,0,0,0
2010,20390,TOR,2,1,0,0,0,3
2010,20391,CHI,1,1,1,0,1,4
2010,20391,CBJ,0,2,1,0,0,3
2010,20392,ANA,1,1,1,0,0,3
2010,20392,LAK,2,1,1,0,0,4
2010,20393,OTT,1,1,0,0,0,2
2010,20393,SJS,2,2,1,0,0,5
2010,20394,BOS,2,2,0,0,0,4
2010,20394,TBL,0,0,1,0,0,1
2010,20395,NJD,2,0,0,0,0,2
2010,20395,VAN,3,0,2,0,0,5
2010,20396,COL,0,2,3,0,0,5
2010,20396,FLA,2,2,1,0,1,6
2010,20397,MIN,3,0,1,1,0,5
2010,20397,NSH,2,1,1,0,0,4
2010,20398,BUF,3,1,2,0,0,6
2010,20398,MTL,0,1,1,0,0,2
2010,20399,PHI,0,0,0,0,0,0
2010,20399,VAN,0,2,1,0,0,3
2010,20400,FLA,0,0,2,0,0,2
2010,20400,WSH,2,2,2,0,0,6
2010,20401,ATL,1,0,0,0,0,1
2010,20401,NYI,0,2,2,0,0,4
2010,20402,CBJ,0,1,2,0,0,3
2010,20402,TOR,2,3,1,0,0,6
2010,20403,COL,1,0,0,0,0,1
2010,20403,PIT,1,0,3,0,0,4
2010,20404,DET,1,0,0,0,0,1
2010,20404,EDM,2,2,0,0,0,4
2010,20405,ANA,1,0,0,0,0,1
2010,20405,DAL,0,0,3,0,0,3
2010,20406,CGY,1,0,0,0,0,1
2010,20406,PHX,0,1,1,0,0,2
2010,20407,LAK,2,2,2,0,0,6
2010,20407,OTT,1,2,0,0,0,3
2010,20408,SJS,1,1,0,0,0,2
2010,20408,STL,1,0,1,0,1,3
2010,20409,NJD,0,0,3,0,0,3
2010,20409,TBL,0,1,1,0,0,2
2010,20410,BOS,0,0,1,0,0,1
2010,20410,MTL,1,4,0,0,0,5
2010,20411,ANA,1,1,2,0,0,4
2010,20411,MIN,0,1,3,0,1,5
2010,20412,CHI,1,0,0,0,0,1
2010,20412,NSH,1,1,2,0,0,4
2010,20413,CAR,1,3,1,0,0,5
2010,20413,VAN,1,0,2,0,0,3
2010,20414,DAL,2,0,0,0,0,2
2010,20414,EDM,0,1,1,0,1,3
2010,20415,LAK,1,1,2,0,0,4
2010,20415,STL,0,2,2,0,1,5
2010,20416,BOS,2,2,3,0,0,7
2010,20416,TOR,0,0,2,0,0,2
2010,20417,BUF,0,0,1,0,0,1
2010,20417,NYR,1,0,1,0,0,2
2010,20418,DET,0,2,1,0,0,3
2010,20418,NJD,2,1,0,0,1,4
2010,20419,PHI,1,0,1,0,0,2
2010,20419,WSH,3,4,1,0,0,8
2010,20420,ATL,0,0,1,0,1,2
2010,20420,FLA,0,0,1,0,0,1
2010,20421,COL,0,2,1,0,0,3
2010,20421,CBJ,0,0,2,0,0,2
2010,20422,CHI,1,0,0,1,0,2
2010,20422,PIT,0,0,1,0,0,1
2010,20423,NYI,0,0,0,0,0,0
2010,20423,TBL,2,0,2,0,0,4
2010,20424,MIN,2,2,1,0,0,5
2010,20424,NSH,1,0,2,0,0,3
2010,20425,OTT,0,0,2,0,0,2
2010,20425,PHX,2,1,0,0,0,3
2010,20426,CGY,0,1,1,0,0,2
2010,20426,SJS,0,1,0,0,0,1
2010,20427,DET,0,1,2,0,0,3
2010,20427,NYR,1,0,0,0,0,1
2010,20428,ANA,2,0,1,0,0,3
2010,20428,OTT,2,0,1,0,1,4
2010,20429,BUF,0,0,0,0,0,0
2010,20429,NJD,2,1,0,0,0,3
2010,20430,ATL,0,0,2,0,0,2
2010,20430,TOR,0,5,0,0,0,5
2010,20431,MTL,0,2,1,0,0,3
2010,20431,PHI,1,0,0,0,0,1
2010,20432,CAR,2,1,0,0,0,3
2010,20432,PIT,0,2,0,0,0,2
2010,20433,TBL,0,0,0,0,0,0
2010,20433,WSH,0,3,0,0,0,3
2010,20434,EDM,0,1,1,0,1,3
2010,20434,FLA,0,1,1,0,0,2
2010,20435,COL,1,2,1,0,0,4
2010,20435,STL,0,0,0,0,0,0
2010,20436,MIN,0,0,0,0,0,0
2010,20436,PHX,0,2,0,0,0,2
2010,20437,CGY,1,0,0,0,0,1
2010,20437,LAK,1,1,0,0,0,2
2010,20438,NYI,0,2,0,0,0,2
2010,20438,PHI,2,3,1,0,0,6
2010,20439,MTL,1,1,2,0,0,4
2010,20439,OTT,0,1,0,0,0,1
2010,20440,NSH,1,1,2,0,0,4
2010,20440,VAN,0,1,1,0,0,2
2010,20441,ANA,0,1,2,1,0,4
2010,20441,DAL,2,1,0,0,0,3
2010,20442,BUF,1,2,0,0,0,3
2010,20442,WSH,0,0,0,0,0,0
2010,20443,NYI,0,0,2,0,0,2
2010,20443,TOR,2,0,1,0,0,3
2010,20444,CAR,0,2,0,0,0,2
2010,20444,NJD,2,1,1,0,0,4
2010,20445,CBJ,1,0,2,0,0,3
2010,20445,FLA,0,0,0,0,0,0
2010,20446,EDM,1,2,0,0,0,3
2010,20446,TBL,1,1,0,0,0,2
2010,20447,DET,0,0,0,0,0,0
2010,20447,STL,1,0,0,0,0,1
2010,20448,CHI,0,0,1,1,0,2
2010,20448,NYR,1,0,0,0,0,1
2010,20449,COL,0,0,0,0,0,0
2010,20449,MIN,1,0,0,0,0,1
2010,20450,ATL,0,0,1,0,0,1
2010,20450,CGY,0,2,1,0,0,3
2010,20451,LAK,1,3,0,1,0,5
2010,20451,SJS,2,1,1,0,0,4
2010,20452,BOS,1,2,2,0,0,5
2010,20452,TOR,0,0,2,0,0,2
2010,20453,OTT,0,0,2,0,0,2
2010,20453,PHI,0,0,0,0,0,0
2010,20454,MTL,0,2,0,0,0,2
2010,20454,PIT,1,1,1,0,0,3
2010,20455,CBJ,0,2,1,0,0,3
2010,20455,NSH,1,2,0,0,1,4
2010,20456,ATL,1,1,0,0,0,2
2010,20456,VAN,2,2,0,0,0,4
2010,20457,LAK,2,0,0,0,1,3
2010,20457,PHX,1,0,1,0,0,2
2010,20458,FLA,1,2,1,0,0,4
2010,20458,NJD,0,1,1,0,0,2
2010,20459,CAR,2,0,1,0,0,3
2010,20459,WSH,0,2,1,1,0,4
2010,20460,BUF,0,2,0,0,0,2
2010,20460,CHI,0,0,1,0,0,1
2010,20461,ANA,0,2,0,0,0,2
2010,20461,DET,0,0,2,1,0,3
2010,20462,EDM,0,1,4,0,0,5
2010,20462,STL,1,2,0,0,0,3
2010,20463,COL,0,0,1,0,1,2
2010,20463,TBL,1,0,0,0,0,1
2010,20464,CGY,0,0,1,0,0,1
2010,20464,MIN,0,0,1,1,0,2
2010,20465,DAL,1,0,1,0,1,3
2010,20465,SJS,2,0,0,0,0,2
2010,20466,TOR,0,3,3,0,0,6
2010,20466,WSH,2,1,0,0,0,3
2010,20467,CAR,0,2,0,0,0,2
2010,20467,OTT,1,1,2,0,0,4
2010,20468,NJD,3,1,0,0,0,4
2010,20468,PHI,0,1,0,0,0,1
2010,20469,BOS,1,1,0,0,0,2
2010,20469,NYI,1,1,0,1,0,3
2010,20470,BUF,2,1,0,0,0,3
2010,20470,NYR,2,0,0,0,0,2
2010,20471,ATL,0,3,0,1,0,4
2010,20471,MTL,1,2,0,0,0,3
2010,20472,ANA,1,1,1,0,0,3
2010,20472,CBJ,0,1,0,0,0,1
2010,20473,FLA,1,0,1,0,0,2
2010,20473,PIT,1,1,0,1,0,3
2010,20474,DET,0,2,0,1,0,3
2010,20474,NSH,0,1,1,0,0,2
2010,20475,PHX,0,2,0,0,0,2
2010,20475,SJS,0,0,1,0,0,1
2010,20476,MIN,2,0,1,0,0,3
2010,20476,VAN,3,0,1,0,0,4
2010,20477,DAL,1,1,0,0,0,2
2010,20477,LAK,0,2,0,0,1,3
2010,20478,CHI,1,2,1,0,0,4
2010,20478,TBL,0,0,0,0,0,0
2010,20479,CGY,0,1,1,0,0,2
2010,20479,COL,1,2,0,0,0,3
2010,20480,BOS,0,1,0,0,0,1
2010,20480,PHI,0,0,3,0,0,3
2010,20481,OTT,0,1,1,0,0,2
2010,20481,TOR,0,2,1,0,0,3
2010,20482,FLA,1,2,4,0,0,7
2010,20482,NYI,0,1,0,0,0,1
2010,20483,ATL,1,0,1,0,1,3
2010,20483,NYR,0,1,1,0,0,2
2010,20484,CBJ,1,1,1,0,0,3
2010,20484,NSH,1,3,1,0,0,5
2010,20485,BUF,0,2,2,0,0,4
2010,20485,MTL,1,0,2,0,0,3
2010,20486,DET,2,1,0,0,0,3
2010,20486,PHX,1,1,0,0,0,2
2010,20487,LAK,1,0,0,0,0,1
2010,20487,VAN,2,0,1,0,0,3
2010,20488,PHI,1,0,0,0,0,1
2010,20488,PIT,3,1,2,0,0,6
2010,20489,CGY,1,2,0,0,0,3
2010,20489,STL,2,1,1,0,0,4
2010,20490,NSH,1,5,1,0,0,7
2010,20490,TBL,2,0,2,0,0,4
2010,20491,CBJ,0,1,0,0,0,1
2010,20491,MIN,0,1,1,0,0,2
2010,20492,COL,0,0,1,0,0,1
2010,20492,WSH,2,3,1,0,0,6
2010,20493,EDM,0,1,1,0,0,2
2010,20493,LAK,1,1,1,0,0,3
2010,20494,MTL,1,0,0,0,0,1
2010,20494,NJD,0,1,1,0,0,2
2010,20495,NYI,1,0,1,0,0,2
2010,20495,NYR,0,0,1,0,0,1
2010,20496,CAR,3,0,2,0,0,5
2010,20496,DAL,1,1,1,0,0,3
2010,20497,PHX,1,4,1,0,0,6
2010,20497,TOR,0,2,1,0,0,3
2010,20498,BUF,0,0,0,0,0,0
2010,20498,OTT,1,0,1,0,0,2
2010,20499,ATL,0,1,2,0,0,3
2010,20499,FLA,2,1,1,0,0,4
2010,20500,CHI,2,1,0,0,0,3
2010,20500,STL,0,0,0,0,0,0
2010,20501,ANA,1,1,1,0,0,3
2010,20501,VAN,1,0,1,0,0,2
2010,20502,MTL,1,0,0,0,0,1
2010,20502,MIN,2,0,1,0,0,3
2010,20503,NYI,0,1,1,0,0,2
2010,20503,NYR,2,1,2,0,0,5
2010,20504,PHI,1,1,0,0,0,2
2010,20504,PIT,1,1,0,0,1,3
2010,20505,ATL,1,2,2,1,0,6
2010,20505,DAL,2,1,2,0,0,5
2010,20506,CBJ,0,0,1,0,0,1
2010,20506,PHX,1,0,0,0,1,2
2010,20507,DET,1,0,2,0,0,3
2010,20507,TBL,0,0,0,0,0,0
2010,20508,CGY,1,0,1,0,0,2
2010,20508,LAK,0,0,1,0,0,1
2010,20509,EDM,2,1,0,0,0,3
2010,20509,NSH,3,2,1,0,0,6
2010,20510,ANA,0,0,1,0,0,1
2010,20510,SJS,0,2,2,0,0,4
2010,20511,NJD,1,2,1,0,0,4
2010,20511,OTT,0,2,0,0,0,2
2010,20512,BUF,0,4,1,0,0,5
2010,20512,TOR,1,0,1,0,0,2
2010,20513,CAR,0,1,2,0,0,3
2010,20513,FLA,0,3,3,0,0,6
2010,20514,STL,1,0,2,0,0,3
2010,20514,TBL,1,2,3,0,0,6
2010,20515,BOS,1,1,2,0,0,4
2010,20515,CHI,0,3,1,0,1,5
2010,20516,VAN,1,1,1,0,0,3
2010,20516,WSH,2,0,0,0,0,2
2010,20517,NYR,1,1,0,0,0,2
2010,20517,PHI,1,0,0,0,0,1
2010,20518,DAL,0,3,1,0,0,4
2010,20518,DET,1,2,0,0,0,3
2010,20519,ANA,1,2,1,0,0,4
2010,20519,PHX,0,1,1,0,0,2
2010,20520,BUF,1,0,0,0,0,1
2010,20520,PIT,1,0,0,0,1,2
2010,20521,BOS,0,0,0,0,0,0
2010,20521,TOR,0,1,1,0,0,2
2010,20522,MIN,0,0,1,0,0,1
2010,20522,OTT,1,2,1,0,0,4
2010,20523,MTL,1,1,1,0,0,3
2010,20523,NYI,0,0,0,0,0,0
2010,20524,CAR,2,1,0,0,0,3
2010,20524,FLA,0,0,2,0,0,2
2010,20525,ATL,3,0,1,0,0,4
2010,20525,NJD,1,3,1,0,0,5
2010,20526,CGY,1,2,0,0,0,3
2010,20526,NSH,2,1,2,0,0,5
2010,20527,COL,4,0,1,0,0,5
2010,20527,CBJ,0,2,0,0,0,2
2010,20528,EDM,0,2,0,0,0,2
2010,20528,WSH,0,0,4,0,0,4
2010,20529,CHI,1,2,0,0,0,3
2010,20529,DET,0,0,0,0,0,0
2010,20530,STL,1,2,0,0,0,3
2010,20530,VAN,1,0,0,0,0,1
2010,20531,BUF,1,0,1,1,0,3
2010,20531,TOR,0,2,0,0,0,2
2010,20532,NYI,1,1,0,0,0,2
2010,20532,TBL,0,2,2,0,0,4
2010,20533,FLA,1,1,2,0,0,4
2010,20533,PHI,0,0,1,0,0,1
2010,20534,CAR,0,1,0,0,0,1
2010,20534,NYR,0,1,2,0,0,3
2010,20535,ATL,1,0,2,0,0,3
2010,20535,MTL,0,2,1,1,0,4
2010,20536,BOS,0,0,2,0,0,2
2010,20536,OTT,0,0,0,0,0,0
2010,20537,NJD,1,3,0,0,0,4
2010,20537,PIT,0,0,0,0,0,0
2010,20538,COL,1,3,0,0,0,4
2010,20538,MIN,0,1,2,0,0,3
2010,20539,DAL,0,0,2,0,0,2
2010,20539,SJS,0,2,2,0,0,4
2010,20540,EDM,1,1,0,0,0,2
2010,20540,STL,1,4,2,0,0,7
2010,20541,CBJ,0,1,1,0,0,2
2010,20541,PHX,2,2,1,0,0,5
2010,20542,CHI,0,0,2,0,0,2
2010,20542,SJS,1,1,1,0,0,3
2010,20543,ANA,0,0,4,0,0,4
2010,20543,COL,1,0,1,0,0,2
2010,20544,NSH,0,0,1,0,0,1
2010,20544,VAN,0,2,2,0,0,4
2010,20545,ATL,2,0,2,0,0,4
2010,20545,BOS,3,1,2,0,0,6
2010,20546,NYI,0,2,1,0,0,3
2010,20546,TOR,0,0,1,0,0,1
2010,20547,FLA,1,0,0,0,0,1
2010,20547,NYR,1,1,2,0,0,4
2010,20548,OTT,1,0,1,0,0,2
2010,20548,PIT,1,5,2,0,0,8
2010,20549,BUF,0,2,0,0,0,2
2010,20549,WSH,2,1,2,0,0,5
2010,20550,MTL,4,1,0,0,0,5
2010,20550,CAR,1,0,0,0,0,1
2010,20551,EDM,1,0,0,0,0,1
2010,20551,MIN,1,1,1,0,0,3
2010,20552,PHI,2,0,3,0,0,5
2010,20552,TBL,0,2,0,0,0,2
2010,20553,CHI,0,1,2,0,0,3
2010,20553,DET,0,0,0,0,0,0
2010,20554,CBJ,1,0,0,0,0,1
2010,20554,DAL,1,1,1,0,0,3
2010,20555,ANA,0,0,0,0,0,0
2010,20555,PHX,2,1,1,0,0,4
2010,20556,CGY,0,0,1,0,0,1
2010,20556,STL,0,1,0,0,1,2
2010,20557,BUF,0,2,0,0,0,2
2010,20557,OTT,0,2,0,0,1,3
2010,20558,MTL,2,0,0,1,0,3
2010,20558,TOR,0,1,1,0,0,2
2010,20559,NYI,1,1,0,1,0,3
2010,20559,NYR,0,0,2,0,0,2
2010,20560,NJD,1,0,0,0,0,1
2010,20560,WSH,2,1,1,0,0,4
2010,20561,CAR,0,0,3,0,0,3
2010,20561,PHI,2,0,1,0,1,4
2010,20562,CBJ,1,0,0,0,0,1
2010,20562,DET,0,1,1,0,0,2
2010,20563,ATL,1,1,1,0,0,3
2010,20563,TBL,1,1,2,0,0,4
2010,20564,CHI,1,3,0,0,0,4
2010,20564,NSH,0,1,0,0,0,1
2010,20565,MIN,1,0,3,0,0,4
2010,20565,STL,0,1,2,0,0,3
2010,20566,LAK,1,0,1,0,0,2
2010,20566,PHX,2,0,1,0,0,3
2010,20567,COL,1,1,2,0,0,4
2010,20567,DAL,0,0,1,0,0,1
2010,20568,EDM,0,1,0,0,0,1
2010,20568,VAN,0,2,2,0,0,4
2010,20569,ANA,0,1,1,0,0,2
2010,20569,SJS,2,3,0,0,0,5
2010,20570,NYI,0,1,0,0,0,1
2010,20570,PHI,1,1,0,0,0,2
2010,20571,BOS,0,1,1,0,0,2
2010,20571,FLA,1,0,0,0,0,1
2010,20572,BUF,1,1,3,0,0,5
2010,20572,STL,1,2,0,0,0,3
2010,20573,PIT,1,1,1,0,0,3
2010,20573,TOR,2,1,1,0,0,4
2010,20574,CHI,1,0,4,0,0,5
2010,20574,NSH,1,1,2,0,0,4
2010,20575,CGY,1,0,0,0,0,1
2010,20575,VAN,4,1,0,0,0,5
2010,20576,ATL,1,0,1,0,0,2
2010,20576,NJD,2,0,1,0,0,3
2010,20577,CAR,3,1,2,0,0,6
2010,20577,WSH,0,2,1,0,0,3
2010,20578,CBJ,0,0,0,1,0,1
2010,20578,DET,0,0,0,0,0,0
2010,20579,MTL,2,0,0,0,0,2
2010,20579,OTT,1,1,2,0,0,4
2010,20580,BOS,0,0,1,0,0,1
2010,20580,TBL,1,1,0,0,0,2
2010,20581,CGY,1,1,2,0,0,4
2010,20581,EDM,1,0,0,0,0,1
2010,20582,LAK,0,1,2,0,0,3
2010,20582,MIN,0,3,1,0,0,4
2010,20583,PHX,0,2,0,0,0,2
2010,20583,SJS,1,1,0,0,1,3
2010,20584,BUF,0,2,2,0,0,4
2010,20584,PIT,2,1,0,0,0,3
2010,20585,CBJ,0,0,1,0,0,1
2010,20585,NYI,1,0,0,0,1,2
2010,20586,NSH,2,1,1,0,0,4
2010,20586,STL,1,0,2,0,0,3
2010,20587,CHI,3,1,0,0,0,4
2010,20587,DAL,2,2,1,0,0,5
2010,20588,PHX,0,2,0,0,1,3
2010,20588,VAN,0,1,1,0,0,2
2010,20589,ANA,2,1,1,0,0,4
2010,20589,MIN,1,0,1,0,0,2
2010,20590,ATL,0,0,0,0,0,0
2010,20590,BOS,3,1,0,0,0,4
2010,20591,NJD,1,0,1,0,0,2
2010,20591,PIT,0,0,0,0,0,0
2010,20592,NYR,0,0,0,0,0,0
2010,20592,PHI,3,2,1,0,0,6
2010,20593,MTL,0,1,0,1,0,2
2010,20593,TBL,0,0,1,0,0,1
2010,20594,COL,2,1,1,0,0,4
2010,20594,OTT,1,0,2,0,0,3
2010,20595,CGY,1,1,0,0,0,2
2010,20595,LAK,0,1,0,0,0,1
2010,20596,EDM,1,1,1,0,0,3
2010,20596,TOR,0,0,1,0,0,1
2010,20597,SJS,2,1,2,0,0,5
2010,20597,WSH,0,0,2,0,0,2
2010,20598,MTL,1,2,2,0,0,5
2010,20598,FLA,2,1,1,0,0,4
2010,20599,NYI,0,1,1,0,0,2
2010,20599,OTT,0,2,0,0,1,3
2010,20600,COL,0,1,1,0,0,2
2010,20600,DET,0,2,2,0,0,4
2010,20601,CBJ,1,0,0,0,0,1
2010,20601,NSH,0,0,1,1,0,2
2010,20602,PHX,0,2,0,0,0,2
2010,20602,SJS,0,1,1,0,1,3
2010,20603,CAR,1,0,0,0,0,1
2010,20603,NYR,1,0,1,0,0,2
2010,20604,STL,1,2,0,0,0,3
2010,20604,VAN,0,1,2,1,0,4
2010,20605,LAK,3,1,1,0,0,5
2010,20605,MIN,0,1,1,0,0,2
2010,20606,ANA,1,1,1,0,0,3
2010,20606,DAL,1,3,1,0,0,5
2010,20607,CHI,2,1,2,0,0,5
2010,20607,NJD,0,0,1,0,0,1
2010,20608,CGY,0,1,1,0,0,2
2010,20608,EDM,0,0,1,0,0,1
2010,20609,BOS,0,0,1,1,0,2
2010,20609,PHI,0,1,0,0,0,1
2010,20610,ATL,0,3,0,0,0,3
2010,20610,BUF,0,1,2,1,0,4
2010,20611,CAR,0,1,0,1,0,2
2010,20611,NYR,0,0,1,0,0,1
2010,20612,DAL,0,0,1,0,0,1
2010,20612,VAN,0,1,2,0,0,3
2010,20613,PIT,1,0,0,0,0,1
2010,20613,TBL,1,1,1,0,0,3
2010,20614,LAK,1,0,1,0,0,2
2010,20614,WSH,0,1,0,0,0,1
2010,20615,ATL,0,4,1,0,0,5
2010,20615,NYI,3,2,0,0,1,6
2010,20616,COL,0,1,2,0,0,3
2010,20616,CBJ,1,1,0,0,0,2
2010,20617,CGY,0,2,1,0,0,3
2010,20617,TOR,1,0,0,0,0,1
2010,20618,CHI,2,2,2,0,0,6
2010,20618,STL,2,0,1,0,0,3
2010,20619,ANA,1,0,0,0,0,1
2010,20619,NSH,0,1,2,0,0,3
2010,20620,MIN,0,2,1,0,0,3
2010,20620,NJD,0,3,2,0,0,5
2010,20621,DET,1,1,2,0,0,4
2010,20621,PHX,0,1,0,0,0,1
2010,20622,EDM,0,1,0,0,0,1
2010,20622,SJS,2,2,0,0,0,4
2010,20623,BUF,0,1,0,0,0,1
2010,20623,MTL,0,0,0,0,0,0
2010,20624,OTT,4,0,3,0,0,7
2010,20624,PHI,1,3,0,0,0,4
2010,20625,FLA,1,2,3,0,0,6
2010,20625,PIT,2,0,0,0,0,2
2010,20626,ANA,0,0,2,0,0,2
2010,20626,CHI,0,2,3,0,0,5
2010,20627,BOS,0,0,2,0,0,2
2010,20627,NYR,1,1,1,0,0,3
2010,20628,LAK,3,2,1,0,0,6
2010,20628,SJS,0,0,2,0,0,2
2010,20629,FLA,2,0,0,0,0,2
2010,20629,TOR,1,2,0,0,0,3
2010,20630,DAL,0,0,0,0,0,0
2010,20630,NJD,1,3,0,0,0,4
2010,20631,MTL,0,1,1,0,0,2
2010,20631,WSH,0,3,1,0,0,4
2010,20632,BOS,4,0,0,0,0,4
2010,20632,OTT,0,1,0,0,0,1
2010,20633,ATL,0,2,0,0,0,2
2010,20633,PIT,0,3,2,0,0,5
2010,20634,CGY,0,2,1,0,0,3
2010,20634,NSH,0,0,1,0,0,1
2010,20635,CHI,1,1,2,0,0,4
2010,20635,MIN,1,0,0,0,0,1
2010,20636,EDM,0,2,2,0,0,4
2010,20636,PHX,1,3,0,1,0,5
2010,20637,CBJ,2,1,0,0,0,3
2010,20637,VAN,3,3,1,0,0,7
2010,20638,ANA,2,0,2,0,0,4
2010,20638,DET,0,0,1,0,0,1
2010,20639,BUF,3,2,0,0,0,5
2010,20639,TBL,2,1,0,0,0,3
2010,20640,DAL,1,1,0,0,0,2
2010,20640,NYR,2,1,2,0,0,5
2010,20641,PHI,2,1,3,0,0,6
2010,20641,TOR,0,0,2,0,0,2
2010,20642,CGY,1,0,0,0,0,1
2010,20642,MIN,1,2,1,0,0,4
2010,20643,COL,1,0,1,0,0,2
2010,20643,NYI,1,1,1,0,0,3
2010,20644,SJS,0,0,1,1,0,2
2010,20644,STL,0,1,0,0,0,1
2010,20645,BOS,2,0,0,0,0,2
2010,20645,CHI,2,2,1,0,0,5
2010,20646,OTT,0,1,1,0,0,2
2010,20646,WSH,2,0,3,0,0,5
2010,20647,ATL,0,0,1,0,1,2
2010,20647,NYR,0,1,0,0,0,1
2010,20648,MTL,1,0,1,0,0,2
2010,20648,FLA,0,0,0,0,0,0
2010,20649,PHI,3,2,2,0,0,7
2010,20649,PIT,2,1,1,0,0,4
2010,20650,CAR,1,0,1,0,0,2
2010,20650,NSH,2,1,1,0,0,4
2010,20651,CBJ,1,1,2,0,0,4
2010,20651,EDM,1,0,1,0,0,2
2010,20652,PHX,0,0,0,0,0,0
2010,20652,VAN,1,1,2,0,0,4
2010,20653,ANA,0,1,3,0,0,4
2010,20653,STL,1,0,1,0,0,2
2010,20654,DET,1,0,1,0,0,2
2010,20654,LAK,0,0,1,0,0,1
2010,20655,NJD,0,0,2,0,0,2
2010,20655,TBL,1,2,1,0,0,4
2010,20656,CAR,1,1,0,0,0,2
2010,20656,COL,0,0,1,0,0,1
2010,20657,BUF,2,1,0,0,0,3
2010,20657,TOR,0,0,2,0,0,2
2010,20658,DAL,1,3,0,0,0,4
2010,20658,NYI,2,1,0,0,0,3
2010,20659,CGY,1,0,1,0,0,2
2010,20659,CBJ,1,1,1,0,0,3
2010,20660,BOS,0,0,1,0,0,1
2010,20660,NYR,1,1,1,0,0,3
2010,20661,BUF,0,1,2,0,0,3
2010,20661,COL,2,1,0,0,1,4
2010,20662,PIT,1,2,1,0,0,4
2010,20662,TOR,1,0,0,0,0,1
2010,20663,MTL,0,1,0,0,0,1
2010,20663,NJD,1,0,0,1,0,2
2010,20664,FLA,1,2,0,0,0,3
2010,20664,OTT,0,0,0,0,0,0
2010,20665,PHI,1,0,3,0,0,4
2010,20665,TBL,0,0,1,0,0,1
2010,20666,ATL,0,1,0,0,0,1
2010,20666,WSH,3,1,4,0,0,8
2010,20667,ANA,1,2,0,0,0,3
2010,20667,NSH,0,0,2,0,0,2
2010,20668,CHI,3,2,0,0,0,5
2010,20668,MIN,1,0,4,0,1,6
2010,20669,NYI,2,2,0,0,1,5
2010,20669,PHX,1,0,3,0,0,4
2010,20670,CGY,1,1,0,0,1,3
2010,20670,VAN,1,1,0,0,0,2
2010,20671,LAK,0,1,2,0,0,3
2010,20671,STL,1,1,2,0,0,4
2010,20672,DET,0,3,1,0,0,4
2010,20672,SJS,1,0,0,0,0,1
2010,20673,CAR,0,2,2,0,0,4
2010,20673,OTT,0,1,0,0,0,1
2010,20674,CBJ,1,0,1,0,0,2
2010,20674,DAL,0,0,0,0,0,0
2010,20675,ANA,2,0,1,0,0,3
2010,20675,CHI,0,0,1,0,0,1
2010,20676,MIN,1,2,1,0,0,4
2010,20676,PIT,1,1,1,0,0,3
2010,20677,CGY,1,1,0,0,0,2
2010,20677,COL,0,2,0,0,1,3
2010,20678,NSH,2,0,1,0,0,3
2010,20678,VAN,1,1,0,0,0,2
2010,20679,LAK,0,1,0,0,0,1
2010,20679,SJS,1,1,0,0,0,2
2010,20680,CAR,1,1,2,0,0,4
2010,20680,TOR,1,1,0,0,0,2
2010,20681,DET,0,0,0,0,0,0
2010,20681,NYI,2,2,2,0,0,6
2010,20682,NJD,0,0,0,0,1,1
2010,20682,NYR,0,0,0,0,0,0
2010,20683,DAL,0,1,2,0,0,3
2010,20683,PHI,1,4,1,0,0,6
2010,20684,ATL,3,2,1,0,0,6
2010,20684,OTT,1,0,0,0,0,1
2010,20685,TBL,4,1,2,0,0,7
2010,20685,WSH,1,3,0,0,0,4
2010,20686,CBJ,0,1,0,0,0,1
2010,20686,STL,3,0,1,0,0,4
2010,20687,EDM,0,0,3,0,0,3
2010,20687,NSH,3,1,1,0,0,5
2010,20688,PHX,0,0,1,0,0,1
2010,20688,SJS,2,1,0,0,0,3
2010,20689,MIN,2,0,3,0,0,5
2010,20689,VAN,1,1,0,0,0,2
2010,20690,FLA,2,2,0,0,0,4
2010,20690,WSH,0,2,2,0,1,5
2010,20691,CGY,0,1,0,0,0,1
2010,20691,PIT,1,1,1,0,0,3
2010,20692,ANA,1,1,2,0,0,4
2010,20692,BOS,0,3,0,0,0,3
2010,20693,PHI,0,0,0,0,0,0
2010,20693,TOR,0,2,2,0,0,4
2010,20694,NYR,0,0,0,0,0,0
2010,20694,OTT,0,0,2,0,0,2
2010,20695,ATL,0,1,0,0,0,1
2010,20695,BUF,0,1,0,1,0,2
2010,20696,MTL,1,2,2,0,0,5
2010,20696,DAL,2,1,0,0,0,3
2010,20697,FLA,1,0,2,0,0,3
2010,20697,TBL,2,0,0,0,0,2
2010,20698,CAR,0,0,1,0,0,1
2010,20698,DET,1,1,1,0,0,3
2010,20699,MIN,0,0,0,0,0,0
2010,20699,STL,0,0,1,0,0,1
2010,20700,CHI,1,1,1,0,0,3
2010,20700,CBJ,0,0,0,0,0,0
2010,20701,NJD,0,2,1,0,0,3
2010,20701,PHX,2,0,2,0,0,4
2010,20702,EDM,0,2,0,0,0,2
2010,20702,PIT,0,0,3,0,0,3
2010,20703,ANA,0,0,0,0,0,0
2010,20703,LAK,1,3,0,0,0,4
2010,20704,BOS,0,1,0,0,1,2
2010,20704,SJS,0,1,0,0,0,1
2010,20705,TOR,0,1,0,0,0,1
2010,20705,WSH,2,2,2,0,0,6
2010,20706,CGY,0,0,0,0,0,0
2010,20706,NSH,0,0,1,0,0,1
2010,20707,CHI,3,0,3,0,0,6
2010,20707,CBJ,2,2,1,0,0,5
2010,20708,DAL,0,1,1,0,1,3
2010,20708,DET,2,0,0,0,0,2
2010,20709,COL,2,0,1,0,0,3
2010,20709,NJD,0,0,1,0,0,1
2010,20710,BOS,1,2,0,0,0,3
2010,20710,LAK,1,0,2,0,1,4
2010,20711,EDM,1,0,1,0,0,2
2010,20711,SJS,2,2,0,0,0,4
2010,20712,MTL,1,1,0,0,0,2
2010,20712,OTT,1,2,1,0,0,4
2010,20713,BUF,0,1,1,0,0,2
2010,20713,NYI,1,1,0,0,1,3
2010,20714,FLA,3,2,0,0,0,5
2010,20714,TBL,2,0,0,0,0,2
2010,20715,ATL,1,2,2,0,0,5
2010,20715,CAR,1,0,2,0,0,3
2010,20716,NYR,0,1,0,0,0,1
2010,20716,STL,1,0,3,0,0,4
2010,20717,MIN,0,1,3,0,0,4
2010,20717,PHX,2,0,4,0,0,6
2010,20718,PIT,1,1,0,0,0,2
2010,20718,VAN,2,4,0,0,0,6
2010,20719,PHI,2,0,1,0,0,3
2010,20719,WSH,2,1,2,0,0,5
2010,20720,CHI,2,1,0,0,1,4
2010,20720,DET,1,1,1,0,0,3
2010,20721,MTL,2,0,0,0,0,2
2010,20721,NYR,0,3,3,0,0,6
2010,20722,ANA,3,0,2,0,0,5
2010,20722,CGY,2,2,0,0,0,4
2010,20723,BOS,0,0,1,0,0,1
2010,20723,OTT,2,2,1,0,0,5
2010,20724,NJD,0,0,0,0,0,0
2010,20724,NYI,2,2,0,0,0,4
2010,20725,CAR,0,1,1,0,0,2
2010,20725,TBL,1,1,1,0,0,3
2010,20726,CBJ,2,1,1,0,0,4
2010,20726,STL,1,1,0,0,0,2
2010,20727,BUF,1,4,2,0,0,7
2010,20727,PHX,0,1,1,0,0,2
2010,20728,ATL,0,0,0,0,0,0
2010,20728,FLA,0,1,0,0,0,1
2010,20729,NSH,0,1,2,0,0,3
2010,20729,TOR,3,0,1,0,0,4
2010,20730,DAL,1,3,0,0,0,4
2010,20730,MIN,0,1,2,0,0,3
2010,20731,COL,2,2,2,0,0,6
2010,20731,EDM,0,0,0,0,0,0
2010,20732,CGY,0,0,1,0,0,1
2010,20732,SJS,3,3,3,0,0,9
2010,20733,NYR,3,2,3,0,0,8
2010,20733,TBL,1,1,0,0,0,2
2010,20734,CBJ,0,2,1,0,0,3
2010,20734,PHI,1,3,1,0,0,5
2010,20735,DET,0,1,1,0,0,2
2010,20735,WSH,0,1,2,0,0,3
2010,20736,ATL,0,2,2,0,0,4
2010,20736,TOR,2,0,1,0,0,3
2010,20737,CHI,0,1,0,0,0,1
2010,20737,OTT,2,1,1,0,0,4
2010,20738,NYI,0,2,2,0,0,4
2010,20738,PIT,1,3,2,0,0,6
2010,20739,ANA,4,0,1,0,0,5
2010,20739,BUF,0,3,1,0,0,4
2010,20740,LAK,0,1,0,0,0,1
2010,20740,SJS,3,1,1,0,0,5
2010,20741,FLA,0,0,0,0,0,0
2010,20741,NJD,0,1,1,0,0,2
2010,20742,MTL,1,0,2,0,0,3
2010,20742,STL,3,0,0,1,0,4
2010,20743,EDM,1,1,0,0,0,2
2010,20743,VAN,1,0,1,1,0,3
2010,20744,BOS,1,1,0,0,0,2
2010,20744,CBJ,1,0,2,0,0,3
2010,20745,OTT,1,1,1,0,0,3
2010,20745,STL,0,1,1,0,0,2
2010,20746,FLA,0,1,0,0,0,1
2010,20746,NYI,0,1,0,0,1,2
2010,20747,NYR,0,0,0,0,0,0
2010,20747,PHI,1,1,0,0,0,2
2010,20748,ATL,0,1,1,0,0,2
2010,20748,CAR,2,2,1,0,0,5
2010,20749,TBL,0,1,1,1,0,3
2010,20749,TOR,0,1,1,0,0,2
2010,20750,PIT,1,2,0,0,0,3
2010,20750,WSH,1,2,3,0,0,6
2010,20751,DET,1,0,2,0,1,4
2010,20751,MIN,0,1,2,0,0,3
2010,20752,NSH,0,2,0,0,0,2
2010,20752,PHX,0,1,3,0,0,4
2010,20753,CGY,0,1,0,0,0,1
2010,20753,CHI,0,1,2,0,0,3
2010,20754,DAL,1,1,1,0,0,3
2010,20754,VAN,1,1,2,0,0,4
2010,20755,BUF,0,2,1,0,0,3
2010,20755,LAK,1,1,1,0,1,4
2010,20756,ANA,0,0,1,0,0,1
2010,20756,SJS,0,2,1,0,0,3
2010,20757,MTL,1,1,1,0,0,3
2010,20757,NJD,1,0,0,0,0,1
2010,20758,COL,1,1,0,0,0,2
2010,20758,NSH,0,1,0,0,0,1
2010,20759,DAL,2,1,1,0,0,4
2010,20759,EDM,1,1,1,0,0,3
2010,20760,BOS,0,1,0,0,0,1
2010,20760,OTT,1,1,0,0,0,2
2010,20761,CAR,1,0,1,0,0,2
2010,20761,PHI,1,2,1,0,0,4
2010,20762,MTL,1,4,1,0,0,6
2010,20762,NYR,0,0,0,0,0,0
2010,20763,NJD,1,1,2,0,0,4
2010,20763,NYI,0,2,0,0,0,2
2010,20764,PHX,1,0,1,0,0,2
2010,20764,WSH,1,2,1,0,0,4
2010,20765,FLA,0,1,1,0,0,2
2010,20765,TOR,0,0,0,0,0,0
2010,20766,DET,2,0,0,0,0,2
2010,20766,LAK,0,1,2,0,0,3
2010,20767,ATL,1,0,0,0,0,1
2010,20767,TBL,1,0,0,0,1,2
2010,20768,ANA,0,0,3,0,1,4
2010,20768,STL,0,2,1,0,0,3
2010,20769,CBJ,0,0,2,0,0,2
2010,20769,MIN,1,2,1,0,0,4
2010,20770,CHI,0,0,1,0,0,1
2010,20770,VAN,3,0,2,0,0,5
2010,20771,BUF,1,0,1,0,0,2
2010,20771,SJS,0,2,3,0,0,5
2010,20772,PHI,1,0,0,0,0,1
2010,20772,PIT,1,0,1,0,0,2
2010,20773,BOS,0,0,1,0,0,1
2010,20773,CAR,1,3,1,0,0,5
2010,20774,COL,2,1,1,0,0,4
2010,20774,DAL,0,0,0,0,0,0
2010,20775,NYR,0,1,1,0,0,2
2010,20775,PIT,1,0,3,0,0,4
2010,20776,CGY,0,0,0,0,0,0
2010,20776,STL,0,1,1,0,0,2
2010,20777,BUF,0,1,1,0,0,2
2010,20777,VAN,0,2,1,0,0,3
2010,20778,LAK,1,3,1,0,0,5
2010,20778,TOR,1,1,1,0,0,3
2010,20779,NYI,1,1,0,0,0,2
2010,20779,WSH,4,2,1,0,0,7
2010,20780,ANA,0,1,0,0,0,1
2010,20780,ATL,0,1,1,0,0,2
2010,20781,CBJ,0,1,2,0,0,3
2010,20781,NSH,0,0,2,0,0,2
2010,20782,NJD,0,0,0,0,0,0
2010,20782,OTT,2,1,0,0,0,3
2010,20783,MTL,0,1,0,0,0,1
2010,20783,FLA,0,0,2,0,0,2
2010,20784,DET,1,1,2,0,0,4
2010,20784,PHX,0,2,2,1,0,5
2010,20785,CHI,1,3,0,0,0,4
2010,20785,EDM,0,1,1,0,0,2
2010,20786,BUF,1,0,0,0,1,2
2010,20786,NJD,0,1,0,0,0,1
2010,20787,CAR,2,1,2,0,0,5
2010,20787,NYR,0,1,0,0,0,1
2010,20788,ANA,0,1,0,0,0,1
2010,20788,WSH,1,0,4,0,0,5
2010,20789,MTL,0,0,0,0,0,0
2010,20789,TBL,1,2,0,0,0,3
2010,20790,DET,2,0,0,0,0,2
2010,20790,MIN,3,0,2,0,0,5
2010,20791,CGY,2,1,0,0,0,3
2010,20791,DAL,1,1,1,0,1,4
2010,20792,STL,1,0,1,0,0,2
2010,20792,VAN,1,0,2,0,0,3
2010,20793,ATL,1,0,3,0,0,4
2010,20793,PHI,0,3,0,0,0,3
2010,20794,OTT,2,0,2,0,0,4
2010,20794,PIT,1,0,0,0,0,1
2010,20795,CAR,2,0,2,0,0,4
2010,20795,NYI,0,0,1,0,0,1
2010,20796,CBJ,0,0,1,0,0,1
2010,20796,LAK,1,1,2,0,0,4
2010,20797,COL,0,0,0,0,0,0
2010,20797,MIN,0,0,1,0,0,1
2010,20798,CGY,0,1,1,0,0,2
2010,20798,PHX,0,2,0,0,1,3
2010,20799,EDM,0,1,0,0,0,1
2010,20799,STL,0,1,1,0,0,2
2010,20800,CHI,3,0,0,1,0,4
2010,20800,SJS,1,1,1,0,0,3
2010,20801,NJD,2,2,0,1,0,5
2010,20801,TOR,1,1,2,0,0,4
2010,20802,FLA,0,1,0,0,0,1
2010,20802,WSH,1,1,2,0,0,4
2010,20803,BOS,0,1,0,0,0,1
2010,20803,BUF,2,0,0,0,0,2
2010,20804,ANA,0,1,0,0,1,2
2010,20804,TBL,1,0,0,0,0,1
2010,20805,DET,1,2,1,0,0,4
2010,20805,NSH,1,0,1,0,0,2
2010,20806,COL,1,1,0,0,0,2
2010,20806,DAL,2,0,1,0,0,3
2010,20807,MTL,0,1,1,0,0,2
2010,20807,OTT,1,1,0,1,0,3
2010,20808,BOS,0,1,1,0,0,2
2010,20808,LAK,1,0,1,0,1,3
2010,20809,TOR,3,0,0,0,0,3
2010,20809,VAN,0,1,4,0,0,5
2010,20810,NYI,0,1,0,0,0,1
2010,20810,PHI,2,0,0,0,0,2
2010,20811,CAR,1,1,2,0,0,4
2010,20811,CHI,0,1,1,0,0,2
2010,20812,CBJ,1,1,0,1,0,3
2010,20812,STL,1,0,1,0,0,2
2010,20813,ATL,1,2,0,0,0,3
2010,20813,NSH,2,1,1,0,0,4
2010,20814,NYR,0,0,2,0,0,2
2010,20814,PHX,3,0,0,0,0,3
2010,20815,CGY,2,3,1,0,0,6
2010,20815,EDM,1,0,0,0,0,1
2010,20816,MIN,2,0,0,0,0,2
2010,20816,SJS,1,2,2,0,0,5
2010,20817,DET,0,0,1,0,0,1
2010,20817,PIT,0,1,0,0,1,2
2010,20818,TBL,0,0,2,0,0,2
2010,20818,WSH,0,2,1,0,0,3
2010,20819,LAK,0,1,2,0,0,3
2010,20819,NJD,1,1,0,0,0,2
2010,20820,FLA,1,1,0,0,0,2
2010,20820,NYI,0,0,0,0,0,0
2010,20821,DAL,0,1,1,0,0,2
2010,20821,PHX,1,1,2,0,0,4
2010,20822,COL,0,0,1,0,0,1
2010,20822,NYR,1,1,1,0,0,3
2010,20823,BUF,2,1,1,0,0,4
2010,20823,PIT,1,4,0,0,0,5
2010,20824,ANA,0,2,1,0,0,3
2010,20824,FLA,0,0,0,0,0,0
2010,20825,CGY,0,0,0,0,0,0
2010,20825,PHI,0,1,2,0,0,3
2010,20826,CAR,1,1,0,0,0,2
2010,20826,EDM,2,2,0,0,0,4
2010,20827,BOS,0,0,0,0,0,0
2010,20827,WSH,0,0,0,0,0,0
2010,20828,NJD,0,0,0,0,0,0
2010,20828,TOR,1,2,0,0,0,3
2010,20829,ATL,0,1,0,0,0,1
2010,20829,TBL,2,0,0,0,0,2
2010,20830,MTL,2,0,1,0,0,3
2010,20830,VAN,1,0,1,0,0,2
2010,20831,NSH,0,0,0,0,0,0
2010,20831,PHX,0,0,0,0,1,1
2010,20832,DAL,1,2,1,0,0,4
2010,20832,MIN,0,1,1,0,0,2
2010,20833,COL,1,1,3,0,0,5
2010,20833,CBJ,1,0,0,0,0,1
2010,20834,LAK,0,1,1,0,0,2
2010,20834,NYR,0,0,1,0,0,1
2010,20835,DET,2,0,2,0,0,4
2010,20835,SJS,2,0,0,0,0,2
2010,20836,BUF,0,0,0,0,0,0
2010,20836,OTT,0,0,0,0,0,0
2010,20837,CHI,1,0,1,0,0,2
2010,20837,STL,0,3,0,0,0,3
2010,20838,CGY,1,2,1,0,0,4
2010,20838,CAR,0,1,0,0,0,1
2010,20839,EDM,0,0,1,0,0,1
2010,20839,PHI,0,0,0,0,0,0
2010,20840,ANA,2,1,0,0,0,3
2010,20840,DET,0,1,0,0,0,1
2010,20841,BOS,1,1,0,0,0,2
2010,20841,MTL,0,2,0,0,1,3
2010,20842,NYR,2,3,0,0,0,5
2010,20842,WSH,1,3,2,0,0,6
2010,20843,CBJ,1,0,1,0,0,2
2010,20843,DAL,0,0,1,0,0,1
2010,20844,OTT,2,0,1,0,0,3
2010,20844,VAN,0,0,1,0,0,1
2010,20845,NYI,1,1,0,0,0,2
2010,20845,TBL,1,2,2,0,0,5
2010,20846,SJS,2,1,1,0,0,4
2010,20846,STL,1,0,1,0,0,2
2010,20847,COL,1,1,1,0,0,3
2010,20847,NSH,0,4,1,0,0,5
2010,20848,EDM,0,1,1,0,0,2
2010,20848,MIN,0,1,3,0,0,4
2010,20849,ANA,1,0,3,0,0,4
2010,20849,LAK,1,2,3,0,0,6
2010,20850,NJD,1,0,3,0,0,4
2010,20850,TOR,0,3,0,0,0,3
2010,20851,ATL,1,0,1,0,0,2
2010,20851,WSH,1,1,3,0,0,5
2010,20852,BUF,1,0,2,0,0,3
2010,20852,CAR,1,0,3,0,0,4
2010,20853,CGY,1,1,0,0,0,2
2010,20853,FLA,0,1,0,0,0,1
2010,20854,CHI,1,0,0,0,0,1
2010,20854,PHX,0,1,0,0,1,2
2010,20855,BOS,2,0,0,0,0,2
2010,20855,VAN,0,1,1,0,1,3
2010,20856,MTL,1,2,2,0,0,5
2010,20856,PIT,1,1,1,0,0,3
2010,20857,DET,0,0,0,0,0,0
2010,20857,LAK,0,0,0,0,0,0
2010,20858,DAL,2,2,0,0,0,4
2010,20858,PHX,0,0,0,0,0,0
2010,20859,OTT,0,0,0,0,0,0
2010,20859,TOR,3,1,1,0,0,5
2010,20860,CAR,1,1,1,0,0,3
2010,20860,NYI,0,1,0,0,0,1
2010,20861,NJD,0,0,1,0,0,1
2010,20861,NYR,0,3,0,0,0,3
2010,20862,ATL,0,2,2,0,0,4
2010,20862,FLA,2,0,0,0,0,2
2010,20863,CGY,0,0,0,0,0,0
2010,20863,TBL,0,0,0,0,0,0
2010,20864,BUF,0,0,0,0,0,0
2010,20864,CBJ,0,2,2,0,0,4
2010,20865,CHI,2,0,0,0,0,2
2010,20865,STL,0,0,1,0,0,1
2010,20866,NSH,1,2,0,0,0,3
2010,20866,SJS,1,2,1,0,0,4
2010,20867,MIN,1,1,0,0,0,2
2010,20867,PHI,1,0,0,0,0,1
2010,20868,COL,0,1,2,0,0,3
2010,20868,EDM,0,0,0,0,0,0
2010,20869,BOS,2,0,1,0,0,3
2010,20869,MTL,0,0,0,0,0,0
2010,20870,PIT,2,2,0,0,0,4
2010,20870,WSH,0,2,2,1,0,5
2010,20871,SJS,0,2,1,0,0,3
2010,20871,TOR,1,1,0,0,0,2
2010,20872,NJD,1,1,0,0,0,2
2010,20872,PHI,0,2,1,0,0,3
2010,20873,COL,2,3,0,0,0,5
2010,20873,STL,2,0,0,0,0,2
2010,20874,EDM,0,0,0,0,0,0
2010,20874,PHX,0,0,0,0,0,0
2010,20875,ANA,1,3,0,0,0,4
2010,20875,LAK,1,1,0,0,0,2
2010,20876,BOS,2,0,0,0,1,3
2010,20876,BUF,0,2,0,0,0,2
2010,20877,NSH,0,2,1,0,0,3
2010,20877,NYI,0,2,1,0,1,4
2010,20878,CAR,0,2,2,0,0,4
2010,20878,FLA,0,1,0,0,0,1
2010,20879,CGY,1,1,0,0,0,2
2010,20879,OTT,1,2,0,0,0,3
2010,20880,TBL,1,0,2,0,0,3
2010,20880,VAN,0,1,0,0,0,1
2010,20881,DET,1,0,2,0,0,3
2010,20881,STL,0,2,1,0,1,4
2010,20882,CHI,2,0,1,0,1,4
2010,20882,DAL,2,0,1,0,0,3
2010,20883,NJD,2,0,0,0,0,2
2010,20883,PHI,1,1,0,1,0,3
2010,20884,NSH,1,1,0,0,0,2
2010,20884,NYR,0,1,0,0,0,1
2010,20885,CBJ,1,1,1,0,0,3
2010,20885,SJS,0,0,0,0,0,0
2010,20886,MTL,1,4,0,1,0,6
2010,20886,WSH,1,1,3,0,0,5
2010,20887,NYI,0,0,1,0,0,1
2010,20887,PIT,0,2,1,0,0,3
2010,20888,MIN,1,0,1,0,0,2
2010,20888,PHX,1,1,1,0,0,3
2010,20889,ATL,1,1,1,0,0,3
2010,20889,COL,1,0,2,1,0,4
2010,20890,ANA,1,1,1,0,0,3
2010,20890,EDM,0,2,0,0,0,2
2010,20891,OTT,3,1,2,0,0,6
2010,20891,WSH,1,3,1,0,0,5
2010,20892,BUF,2,0,1,0,0,3
2010,20892,CAR,2,1,0,1,0,4
2010,20893,BOS,4,1,0,0,0,5
2010,20893,TBL,0,2,2,0,0,4
2010,20894,FLA,0,0,0,0,0,0
2010,20894,VAN,0,2,1,0,0,3
2010,20895,DET,1,0,1,0,0,2
2010,20895,SJS,2,0,0,0,1,3
2010,20896,CGY,1,0,0,0,0,1
2010,20896,DAL,0,1,2,0,0,3
2010,20897,EDM,0,1,1,0,1,3
2010,20897,LAK,0,0,2,0,0,2
2010,20898,NSH,1,1,0,0,0,2
2010,20898,NJD,1,1,3,0,0,5
2010,20899,MTL,0,0,2,0,0,2
2010,20899,PHI,1,2,0,0,0,3
2010,20900,CBJ,2,1,0,0,0,3
2010,20900,VAN,1,1,2,0,0,4
2010,20901,NYR,0,2,0,1,0,3
2010,20901,PIT,1,0,1,0,0,2
2010,20902,STL,1,2,1,0,0,4
2010,20902,TOR,0,0,0,0,0,0
2010,20903,ATL,2,0,1,0,0,3
2010,20903,MIN,2,0,0,0,0,2
2010,20904,COL,1,0,1,0,0,2
2010,20904,PHX,0,1,0,0,0,1
2010,20905,NYI,1,3,1,0,0,5
2010,20905,TBL,2,1,1,0,0,4
2010,20906,BUF,0,3,0,0,0,3
2010,20906,SJS,0,0,1,0,0,1
2010,20907,MTL,0,1,1,0,0,2
2010,20907,PHI,3,2,1,0,0,6
2010,20908,CAR,1,2,2,0,0,5
2010,20908,NJD,0,0,2,0,0,2
2010,20909,BOS,1,0,1,0,1,3
2010,20909,FLA,2,0,0,0,0,2
2010,20910,DET,2,1,1,0,0,4
2010,20910,OTT,0,1,0,0,0,1
2010,20911,STL,1,2,0,0,1,4
2010,20911,WSH,1,2,0,0,0,3
2010,20912,DAL,0,2,1,0,0,3
2010,20912,PHX,0,0,0,0,0,0
2010,20913,ATL,1,3,0,0,0,4
2010,20913,CHI,3,0,1,0,1,5
2010,20914,ANA,1,0,0,0,0,1
2010,20914,CGY,1,2,0,0,0,3
2010,20915,COL,0,0,0,0,0,0
2010,20915,LAK,0,1,2,0,0,3
2010,20916,NYR,0,4,1,0,0,5
2010,20916,TBL,2,0,0,0,0,2
2010,20917,NSH,0,2,1,0,1,4
2010,20917,PIT,1,1,1,0,0,3
2010,20918,MIN,1,2,3,0,0,6
2010,20918,VAN,0,0,2,0,0,2
2010,20919,NYI,1,2,0,0,0,3
2010,20919,OTT,1,0,3,0,0,4
2010,20920,CHI,1,3,0,0,1,5
2010,20920,CBJ,2,1,1,0,0,4
2010,20921,ANA,2,1,4,0,0,7
2010,20921,EDM,1,1,1,0,0,3
2010,20922,COL,0,2,0,0,0,2
2010,20922,DET,2,0,1,0,0,3
2010,20923,BOS,1,0,0,0,0,1
2010,20923,MTL,0,0,4,0,0,4
2010,20924,CAR,1,3,1,0,0,5
2010,20924,TOR,0,0,1,0,0,1
2010,20925,CHI,2,0,1,0,0,3
2010,20925,NYI,1,4,0,0,0,5
2010,20926,ATL,2,2,0,0,0,4
2010,20926,FLA,2,0,0,0,0,2
2010,20927,CBJ,2,1,0,0,0,3
2010,20927,VAN,0,2,1,1,0,4
2010,20928,NYR,0,4,0,0,0,4
2010,20928,OTT,1,0,0,0,0,1
2010,20929,BUF,0,1,1,0,0,2
2010,20929,PIT,1,1,1,0,0,3
2010,20930,PHI,1,1,5,0,0,7
2010,20930,TBL,1,1,0,0,0,2
2010,20931,EDM,1,1,1,0,0,3
2010,20931,NSH,2,1,1,0,0,4
2010,20932,DAL,0,0,1,0,0,1
2010,20932,LAK,1,3,1,0,0,5
2010,20933,PHX,1,0,1,0,0,2
2010,20933,STL,2,3,0,0,0,5
2010,20934,NJD,0,3,1,0,0,4
2010,20934,SJS,0,0,3,0,0,3
2010,20935,BUF,0,1,0,0,0,1
2010,20935,WSH,0,1,2,0,0,3
2010,20936,FLA,2,4,1,0,0,7
2010,20936,PHI,0,3,1,0,0,4
2010,20937,DET,1,1,1,0,0,3
2010,20937,VAN,2,3,1,0,0,6
2010,20938,CHI,0,2,3,0,0,5
2010,20938,EDM,0,2,0,0,0,2
2010,20939,CGY,0,0,0,0,0,0
2010,20939,MIN,1,2,1,0,0,4
2010,20940,ANA,1,1,1,0,0,3
2010,20940,COL,0,2,2,0,0,4
2010,20941,BOS,1,1,0,0,1,3
2010,20941,TOR,1,0,1,0,0,2
2010,20942,NYR,2,2,0,0,0,4
2010,20942,PIT,2,1,1,1,0,5
2010,20943,TBL,1,1,2,0,0,4
2010,20943,WSH,1,2,2,0,0,5
2010,20944,CAR,2,1,1,0,0,4
2010,20944,OTT,0,0,1,0,0,1
2010,20945,ATL,4,2,0,0,0,6
2010,20945,NYI,1,0,2,0,0,3
2010,20946,LAK,1,0,1,0,0,2
2010,20946,NSH,1,1,2,0,0,4
2010,20947,DAL,1,0,0,0,0,1
2010,20947,STL,3,1,2,0,0,6
2010,20948,COL,0,1,0,0,0,1
2010,20948,PHX,1,0,2,0,0,3
2010,20949,MTL,1,1,0,0,0,2
2010,20949,SJS,0,1,2,0,0,3
2010,20950,BUF,0,1,1,1,0,3
2010,20950,PHI,0,1,1,0,0,2
2010,20951,DET,2,2,1,0,0,5
2010,20951,NSH,0,1,1,0,0,2
2010,20952,CHI,5,1,0,0,0,6
2010,20952,VAN,1,1,1,0,0,3
2010,20953,CGY,0,3,2,0,0,5
2010,20953,NJD,1,0,2,0,0,3
2010,20954,EDM,1,0,0,0,1,2
2010,20954,MIN,0,1,0,0,0,1
2010,20955,DAL,1,2,0,0,0,3
2010,20955,PIT,1,3,2,0,0,6
2010,20956,BOS,1,2,0,0,0,3
2010,20956,NYI,0,1,1,0,0,2
2010,20957,OTT,1,0,0,0,0,1
2010,20957,TOR,0,1,0,0,1,2
2010,20958,NYR,0,0,0,0,0,0
2010,20958,WSH,1,1,0,0,0,2
2010,20959,CAR,0,0,1,0,0,1
2010,20959,FLA,2,0,2,0,0,4
2010,20960,ATL,1,1,0,0,0,2
2010,20960,TBL,3,1,2,0,0,6
2010,20961,ANA,0,0,0,0,0,0
2010,20961,PHX,1,2,1,0,0,4
2010,20962,COL,2,4,1,0,0,7
2010,20962,STL,1,1,1,0,0,3
2010,20963,MTL,1,1,2,0,0,4
2010,20963,LAK,1,0,1,0,0,2
2010,20964,CBJ,0,1,0,0,0,1
2010,20964,SJS,0,0,2,0,0,2
2010,20965,BOS,0,1,0,0,0,1
2010,20965,PIT,0,1,1,0,0,2
2010,20966,NSH,1,1,0,0,0,2
2010,20966,VAN,1,0,3,0,0,4
2010,20967,CGY,2,1,2,0,0,5
2010,20967,MIN,0,2,0,0,0,2
2010,20968,ATL,0,0,0,0,0,0
2010,20968,CAR,1,1,2,0,0,4
2010,20969,BUF,0,0,1,1,0,2
2010,20969,NYR,0,0,1,0,0,1
2010,20970,PHI,1,2,0,0,0,3
2010,20970,TOR,0,1,0,0,0,1
2010,20971,CHI,2,0,2,0,0,4
2010,20971,DET,0,5,0,0,0,5
2010,20972,EDM,0,1,1,0,0,2
2010,20972,NJD,0,0,0,0,0,0
2010,20973,ANA,3,0,0,0,0,3
2010,20973,MTL,0,1,2,0,1,4
2010,20974,DAL,0,0,3,0,1,4
2010,20974,WSH,1,1,1,0,0,3
2010,20975,CBJ,0,0,0,0,0,0
2010,20975,LAK,4,2,0,0,0,6
2010,20976,BOS,1,1,1,0,0,3
2010,20976,TOR,0,2,1,1,0,4
2010,20977,NYI,1,1,0,0,0,2
2010,20977,PHI,0,1,2,0,0,3
2010,20978,ATL,0,1,0,0,0,1
2010,20978,NSH,2,0,0,0,0,2
2010,20979,MTL,2,2,1,0,0,5
2010,20979,TBL,0,2,1,0,0,3
2010,20980,CGY,0,1,3,0,0,4
2010,20980,DET,0,2,0,0,0,2
2010,20981,FLA,0,0,2,0,1,3
2010,20981,MIN,2,0,0,0,0,2
2010,20982,COL,3,1,0,0,0,4
2010,20982,VAN,0,3,3,0,0,6
2010,20983,EDM,0,1,0,0,0,1
2010,20983,OTT,0,1,3,0,0,4
2010,20984,ANA,0,0,2,0,0,2
2010,20984,CBJ,1,2,2,0,0,5
2010,20985,BUF,3,1,1,0,0,5
2010,20985,DAL,3,0,0,0,0,3
2010,20986,NJD,2,3,1,0,0,6
2010,20986,NYR,1,2,0,0,0,3
2010,20987,CAR,1,2,0,0,0,3
2010,20987,WSH,2,1,0,1,0,4
2010,20988,CHI,1,1,0,1,0,3
2010,20988,LAK,0,2,0,0,0,2
2010,20989,PHX,1,1,1,0,1,4
2010,20989,VAN,1,1,1,0,0,3
2010,20990,TBL,1,1,1,0,0,3
2010,20990,TOR,0,2,1,1,0,4
2010,20991,NYI,1,0,0,0,0,1
2010,20991,STL,0,1,0,0,1,2
2010,20992,BOS,1,3,1,0,0,5
2010,20992,PHI,0,1,0,0,0,1
2010,20993,CAR,2,1,0,1,0,4
2010,20993,PIT,2,1,0,0,0,3
2010,20994,ATL,0,0,1,0,0,1
2010,20994,CBJ,1,1,0,0,0,2
2010,20995,MTL,2,1,1,0,1,5
2010,20995,EDM,2,0,2,0,0,4
2010,20996,DET,3,1,1,0,0,5
2010,20996,MIN,1,0,0,0,0,1
2010,20997,COL,0,2,1,0,0,3
2010,20997,FLA,0,0,0,0,0,0
2010,20998,CGY,1,0,1,0,0,2
2010,20998,OTT,0,0,0,0,0,0
2010,20999,NSH,1,3,1,0,0,5
2010,20999,SJS,1,1,6,0,0,8
2010,21000,NJD,1,0,2,0,0,3
2010,21000,PIT,1,0,0,0,0,1
2010,21001,TBL,1,2,0,0,0,3
2010,21001,WSH,1,0,1,0,0,2
2010,21002,BUF,0,0,2,0,0,2
2010,21002,MIN,2,1,0,0,0,3
2010,21003,ATL,0,1,1,0,0,2
2010,21003,NYR,3,1,1,0,0,5
2010,21004,DAL,0,0,1,0,0,1
2010,21004,LAK,1,0,0,0,1,2
2010,21005,ANA,0,0,0,0,0,0
2010,21005,NSH,1,0,0,0,0,1
2010,21006,CHI,0,0,2,0,0,2
2010,21006,PHI,0,0,3,0,0,3
2010,21007,EDM,0,2,2,0,0,4
2010,21007,TOR,2,3,1,0,0,6
2010,21008,BOS,0,1,1,0,0,2
2010,21008,MTL,2,0,1,0,0,3
2010,21009,NJD,1,0,1,0,0,2
2010,21009,NYI,1,2,1,0,0,4
2010,21010,CAR,0,0,0,0,0,0
2010,21010,PHX,2,1,1,0,0,4
2010,21011,BUF,1,1,0,0,0,2
2010,21011,DET,2,0,0,1,0,3
2010,21012,CBJ,0,0,1,0,0,1
2010,21012,STL,0,3,2,0,0,5
2010,21013,OTT,0,1,0,0,0,1
2010,21013,VAN,1,3,1,0,0,5
2010,21014,FLA,0,1,1,1,0,3
2010,21014,SJS,2,0,0,0,0,2
2010,21015,NYR,0,2,1,0,0,3
2010,21015,PHI,1,0,0,0,0,1
2010,21016,COL,1,3,1,0,0,5
2010,21016,DAL,1,2,0,0,0,3
2010,21017,LAK,1,0,1,0,0,2
2010,21017,NSH,1,0,2,0,0,3
2010,21018,NYI,2,1,1,0,0,4
2010,21018,TOR,1,0,0,0,0,1
2010,21019,ATL,0,0,2,0,0,2
2010,21019,PHX,0,1,1,0,1,3
2010,21020,PIT,0,0,2,0,0,2
2010,21020,TBL,0,1,0,0,0,1
2010,21021,MIN,3,1,0,0,0,4
2010,21021,STL,0,1,1,0,0,2
2010,21022,CHI,2,1,0,0,0,3
2010,21022,WSH,0,0,3,1,0,4
2010,21023,ANA,3,0,1,0,0,4
2010,21023,SJS,0,0,2,0,0,2
2010,21024,CGY,0,0,1,0,0,1
2010,21024,VAN,3,0,0,0,0,3
2010,21025,BOS,0,1,1,0,0,2
2010,21025,NJD,3,0,0,0,0,3
2010,21026,CBJ,1,1,3,0,0,5
2010,21026,EDM,0,1,2,0,0,3
2010,21027,CGY,1,0,0,0,0,1
2010,21027,DET,0,1,1,0,0,2
2010,21028,MTL,1,0,2,0,0,3
2010,21028,NYR,0,1,0,0,0,1
2010,21029,BOS,1,1,3,0,0,5
2010,21029,CAR,0,1,1,0,0,2
2010,21030,ATL,3,0,1,0,0,4
2010,21030,BUF,1,1,1,0,0,3
2010,21031,OTT,0,1,0,0,0,1
2010,21031,TOR,1,2,1,0,0,4
2010,21032,PHX,2,0,0,0,0,2
2010,21032,TBL,0,1,0,0,0,1
2010,21033,FLA,1,1,1,0,0,3
2010,21033,WSH,2,4,1,0,0,7
2010,21034,COL,2,2,1,0,0,5
2010,21034,STL,1,2,0,0,0,3
2010,21035,NSH,3,0,0,0,1,4
2010,21035,PHI,1,0,2,0,0,3
2010,21036,EDM,0,1,1,0,0,2
2010,21036,MIN,1,1,2,0,0,4
2010,21037,DAL,1,3,4,0,0,8
2010,21037,SJS,0,1,1,0,0,2
2010,21038,NYI,2,2,1,0,0,5
2010,21038,VAN,0,2,0,0,0,2
2010,21039,NJD,2,2,1,0,0,5
2010,21039,PIT,1,0,1,0,0,2
2010,21040,CGY,2,1,0,0,0,3
2010,21040,COL,0,1,1,0,0,2
2010,21041,ANA,1,1,2,0,0,4
2010,21041,CHI,1,0,1,0,0,2
2010,21042,BOS,0,0,0,0,0,0
2010,21042,PIT,1,1,1,0,0,3
2010,21043,NYR,2,0,1,0,0,3
2010,21043,STL,1,2,1,0,0,4
2010,21044,CAR,0,1,2,1,0,4
2010,21044,WSH,0,2,1,0,0,3
2010,21045,ATL,1,2,3,0,0,6
2010,21045,OTT,0,3,0,0,0,3
2010,21046,NJD,0,1,0,0,0,1
2010,21046,TOR,1,0,0,0,1,2
2010,21047,BUF,3,1,2,0,0,6
2010,21047,TBL,0,0,2,0,0,2
2010,21048,FLA,1,2,0,0,0,3
2010,21048,PHX,0,0,3,0,1,4
2010,21049,MIN,0,0,0,0,0,0
2010,21049,NSH,3,1,1,0,0,5
2010,21050,DAL,2,0,0,0,0,2
2010,21050,PHI,1,1,1,0,0,3
2010,21051,SJS,0,1,1,0,0,2
2010,21051,VAN,2,1,0,0,0,3
2010,21052,CHI,0,1,2,0,0,3
2010,21052,LAK,0,0,0,0,0,0
2010,21053,CBJ,0,1,3,0,0,4
2010,21053,MIN,1,1,0,0,0,2
2010,21054,CGY,2,2,0,0,0,4
2010,21054,SJS,0,1,2,0,0,3
2010,21055,DET,0,1,1,0,0,2
2010,21055,EDM,2,0,0,0,1,3
2010,21056,ANA,2,0,2,1,0,5
2010,21056,NYI,2,2,0,0,0,4
2010,21057,CAR,1,0,1,1,0,3
2010,21057,PIT,0,1,1,0,0,2
2010,21058,DAL,2,2,1,0,0,5
2010,21058,OTT,2,1,1,0,0,4
2010,21059,MTL,1,0,1,0,0,2
2010,21059,TOR,1,1,0,0,1,3
2010,21060,NJD,0,0,0,0,0,0
2010,21060,STL,1,0,0,0,0,1
2010,21061,ATL,2,1,2,0,0,5
2010,21061,PHI,1,1,0,0,0,2
2010,21062,BUF,1,1,1,0,0,3
2010,21062,FLA,0,1,0,0,0,1
2010,21063,TBL,1,0,0,0,0,1
2010,21063,WSH,2,0,1,0,0,3
2010,21064,CBJ,0,0,0,0,0,0
2010,21064,NSH,0,0,0,1,0,1
2010,21065,CHI,1,1,2,0,0,4
2010,21065,PHX,0,1,3,0,1,5
2010,21066,DET,0,3,0,1,0,4
2010,21066,VAN,2,0,1,0,0,3
2010,21067,LAK,1,0,0,0,0,1
2010,21067,NYI,0,0,0,0,0,0
2010,21068,BOS,0,1,1,0,0,2
2010,21068,NYR,0,0,1,0,0,1
2010,21069,CGY,1,1,1,0,0,3
2010,21069,MIN,2,2,0,0,0,4
2010,21070,BUF,1,4,0,0,0,5
2010,21070,CAR,0,1,2,0,0,3
2010,21071,FLA,3,0,2,0,0,5
2010,21071,TBL,1,0,1,0,0,2
2010,21072,NSH,0,1,2,0,0,3
2010,21072,STL,1,0,1,0,0,2
2010,21073,ATL,2,0,1,0,0,3
2010,21073,PHI,0,0,1,0,0,1
2010,21074,DAL,0,1,1,0,0,2
2010,21074,PHX,1,1,0,0,1,3
2010,21075,EDM,2,1,2,0,0,5
2010,21075,SJS,0,0,1,0,0,1
2010,21076,ANA,2,2,1,0,0,5
2010,21076,COL,0,0,2,0,0,2
2010,21077,DET,1,1,1,0,0,3
2010,21077,PIT,0,1,0,0,0,1
2010,21078,MTL,0,0,0,0,0,0
2010,21078,OTT,1,0,1,0,0,2
2010,21079,COL,1,0,2,0,0,3
2010,21079,LAK,1,1,1,1,0,4
2010,21080,FLA,1,0,3,0,0,4
2010,21080,TOR,0,0,1,0,0,1
2010,21081,CBJ,0,2,1,0,0,3
2010,21081,NJD,1,4,1,0,0,6
2010,21082,ATL,0,0,0,0,0,0
2010,21082,BOS,1,2,1,0,0,4
2010,21083,OTT,1,0,1,0,0,2
2010,21083,PHI,0,0,0,0,0,0
2010,21084,CAR,0,2,0,0,0,2
2010,21084,TBL,0,1,1,1,0,3
2010,21085,DAL,0,1,2,0,0,3
2010,21085,NSH,0,1,0,0,0,1
2010,21086,MIN,0,1,0,0,0,1
2010,21086,SJS,1,1,2,0,0,4
2010,21087,CHI,0,2,0,0,0,2
2010,21087,PHX,0,0,0,0,0,0
2010,21088,ANA,0,1,0,0,0,1
2010,21088,CGY,1,1,1,0,0,3
2010,21089,EDM,2,1,0,0,0,3
2010,21089,VAN,1,1,0,0,0,2
2010,21090,NYI,0,0,0,0,0,0
2010,21090,NYR,3,0,2,0,0,5
2010,21091,PIT,0,2,1,0,0,3
2010,21091,WSH,0,1,2,0,1,4
2010,21092,BUF,0,0,2,0,1,3
2010,21092,MTL,1,1,0,0,0,2
2010,21093,DET,0,2,2,0,0,4
2010,21093,STL,1,0,1,0,0,2
2010,21094,COL,3,0,0,0,1,4
2010,21094,LAK,1,0,2,0,0,3
2010,21095,ANA,0,0,1,0,0,1
2010,21095,VAN,2,1,1,0,0,4
2010,21096,BOS,1,1,1,0,0,3
2010,21096,TBL,2,2,1,0,0,5
2010,21097,NJD,1,0,2,0,0,3
2010,21097,NYR,0,1,2,0,1,4
2010,21098,CGY,1,1,0,0,0,2
2010,21098,NYI,1,0,2,0,0,3
2010,21099,MIN,0,1,2,1,0,4
2010,21099,PHI,2,1,0,0,0,3
2010,21100,CAR,2,0,0,0,1,3
2010,21100,WSH,0,1,1,0,0,2
2010,21101,ATL,1,0,0,0,0,1
2010,21101,TOR,1,0,0,1,0,2
2010,21102,CHI,0,1,2,0,0,3
2010,21102,CBJ,2,4,2,0,0,8
2010,21103,MTL,2,0,2,0,0,4
2010,21103,FLA,0,0,1,0,0,1
2010,21104,LAK,0,0,1,0,0,1
2010,21104,STL,1,1,1,0,0,3
2010,21105,NSH,1,2,0,0,1,4
2010,21105,PHX,1,0,2,0,0,3
2010,21106,DAL,0,0,0,0,0,0
2010,21106,SJS,0,2,1,0,0,3
2010,21107,BUF,0,1,1,0,0,2
2010,21107,OTT,1,2,1,0,0,4
2010,21108,DET,0,4,2,0,0,6
2010,21108,MIN,0,1,1,0,0,2
2010,21109,ANA,1,0,2,0,0,3
2010,21109,EDM,0,1,1,0,0,2
2010,21110,BOS,1,2,2,0,0,5
2010,21110,CGY,0,0,0,0,0,0
2010,21111,PHI,1,0,0,0,0,1
2010,21111,PIT,1,1,2,0,0,4
2010,21112,BUF,3,3,1,0,0,7
2010,21112,TBL,0,1,0,0,0,1
2010,21113,NYR,2,0,0,0,0,2
2010,21113,TOR,0,1,1,1,0,3
2010,21114,MTL,0,2,0,0,0,2
2010,21114,NJD,1,2,1,0,0,4
2010,21115,FLA,0,1,1,0,0,2
2010,21115,OTT,0,2,1,0,0,3
2010,21116,ATL,0,3,1,0,0,4
2010,21116,CAR,0,0,0,0,0,0
2010,21117,CBJ,0,1,2,0,0,3
2010,21117,NYI,2,0,1,1,0,4
2010,21118,DET,0,0,0,0,1,1
2010,21118,NSH,0,0,0,0,0,0
2010,21119,COL,1,1,0,0,0,2
2010,21119,PHX,1,2,3,0,0,6
2010,21120,SJS,0,3,1,0,0,4
2010,21120,VAN,1,0,1,0,0,2
2010,21121,DAL,0,3,1,0,0,4
2010,21121,LAK,1,0,0,0,0,1
2010,21122,CGY,4,1,0,0,0,5
2010,21122,WSH,0,2,1,0,0,3
2010,21123,PIT,1,2,1,0,1,5
2010,21123,TOR,1,2,1,0,0,4
2010,21124,EDM,1,0,0,0,0,1
2010,21124,STL,0,1,1,0,0,2
2010,21125,NJD,0,0,1,0,0,1
2010,21125,PHI,2,2,1,0,0,5
2010,21126,CHI,1,0,1,0,0,2
2010,21126,CBJ,1,2,1,0,0,4
2010,21127,COL,0,2,1,0,0,3
2010,21127,SJS,1,1,2,0,0,4
2010,21128,BOS,1,0,1,0,0,2
2010,21128,BUF,2,1,0,0,0,3
2010,21129,ATL,1,0,0,0,0,1
2010,21129,CAR,0,2,2,0,0,4
2010,21130,FLA,0,0,2,0,0,2
2010,21130,NSH,0,1,1,1,0,3
2010,21131,LAK,0,1,1,0,0,2
2010,21131,MIN,0,2,1,0,0,3
2010,21132,ANA,0,3,0,0,0,3
2010,21132,DAL,0,1,0,0,0,1
2010,21133,ATL,0,2,1,0,0,3
2010,21133,TOR,0,1,1,0,0,2
2010,21134,BOS,0,0,0,1,0,1
2010,21134,NJD,0,0,0,0,0,0
2010,21135,NYI,2,0,1,0,0,3
2010,21135,NYR,0,3,1,0,0,4
2010,21136,OTT,3,0,1,1,0,5
2010,21136,WSH,1,2,1,0,0,4
2010,21137,CBJ,1,0,2,0,0,3
2010,21137,TBL,1,1,0,0,0,2
2010,21138,DET,3,1,1,0,0,5
2010,21138,EDM,0,2,2,0,0,4
2010,21139,CHI,2,0,0,0,0,2
2010,21139,STL,1,1,2,0,0,4
2010,21140,LAK,0,0,2,0,0,2
2010,21140,NSH,0,0,0,0,0,0
2010,21141,PHX,1,0,0,0,0,1
2010,21141,VAN,3,1,0,0,0,4
2010,21142,BUF,2,2,2,0,0,6
2010,21142,FLA,1,0,1,0,0,2
2010,21143,MTL,1,0,0,0,0,1
2010,21143,CAR,0,1,1,0,0,2
2010,21144,PIT,0,0,0,0,0,0
2010,21144,TBL,1,1,0,0,0,2
2010,21145,CHI,1,1,2,0,0,4
2010,21145,MIN,0,0,0,0,0,0
2010,21146,DAL,2,3,0,0,0,5
2010,21146,SJS,1,0,0,0,0,1
2010,21147,ANA,2,1,2,0,0,5
2010,21147,COL,0,1,1,0,0,2
2010,21148,CGY,0,1,1,0,0,2
2010,21148,PHX,0,0,1,0,0,1
2010,21149,BOS,0,0,0,0,0,0
2010,21149,FLA,1,0,0,0,0,1
2010,21150,BUF,1,1,0,0,0,2
2010,21150,TOR,1,1,2,0,0,4
2010,21151,NYI,3,1,2,0,0,6
2010,21151,PHI,0,1,3,0,0,4
2010,21152,ATL,0,1,0,0,0,1
2010,21152,WSH,1,0,1,0,0,2
2010,21153,CAR,0,2,1,0,0,3
2010,21153,OTT,1,0,2,0,1,4
2010,21154,CBJ,1,0,1,0,0,2
2010,21154,DET,1,1,1,0,0,3
2010,21155,NSH,0,2,1,0,0,3
2010,21155,STL,1,1,0,0,0,2
2010,21156,LAK,3,2,3,0,0,8
2010,21156,VAN,0,2,1,0,0,3
2010,21157,CHI,0,0,1,0,1,2
2010,21157,NJD,1,0,0,0,0,1
2010,21158,MTL,1,0,0,0,0,1
2010,21158,PHI,0,0,0,0,0,0
2010,21159,NYR,4,0,1,0,0,5
2010,21159,TBL,0,0,0,0,0,0
2010,21160,MIN,0,2,0,0,0,2
2010,21160,SJS,2,0,1,0,0,3
2010,21161,DAL,3,0,3,0,0,6
2010,21161,EDM,0,3,0,0,0,3
2010,21162,CGY,0,1,1,0,0,2
2010,21162,COL,0,0,1,0,0,1
2010,21163,ANA,0,2,2,0,0,4
2010,21163,VAN,0,1,3,0,1,5
2010,21164,ATL,1,1,1,0,0,3
2010,21164,PIT,0,1,2,1,0,4
2010,21165,NYI,0,3,1,0,0,4
2010,21165,OTT,0,0,1,0,0,1
2010,21166,DET,1,1,1,0,0,3
2010,21166,NSH,0,3,0,1,0,4
2010,21167,BOS,0,1,0,1,0,2
2010,21167,TOR,1,0,0,0,0,1
2010,21168,BUF,0,0,0,0,0,0
2010,21168,MTL,1,1,1,0,0,3
2010,21169,CAR,0,0,0,0,0,0
2010,21169,NJD,2,0,2,0,0,4
2010,21170,FLA,0,1,0,0,0,1
2010,21170,NYR,0,0,4,0,0,4
2010,21171,CBJ,1,0,1,0,0,2
2010,21171,WSH,3,0,0,0,0,3
2010,21172,DAL,0,1,0,0,0,1
2010,21172,STL,0,1,1,0,0,2
2010,21173,EDM,1,0,1,0,0,2
2010,21173,PHX,1,1,0,0,1,3
2010,21174,ANA,0,0,1,0,1,2
2010,21174,LAK,1,0,0,0,0,1
2010,21175,DET,2,0,1,0,0,3
2010,21175,PHI,2,2,0,0,0,4
2010,21176,CGY,0,1,0,0,0,1
2010,21176,CHI,2,1,1,0,0,4
2010,21177,COL,1,2,1,1,0,5
2010,21177,SJS,2,0,2,0,0,4
2010,21178,MIN,0,0,3,0,0,3
2010,21178,VAN,1,1,1,1,0,4
2010,21179,BOS,1,1,0,0,0,2
2010,21179,WSH,1,1,0,1,0,3
2010,21180,CBJ,1,0,0,0,0,1
2010,21180,STL,0,1,0,1,0,2
2010,21181,EDM,2,0,2,0,0,4
2010,21181,MIN,0,1,0,0,0,1
2010,21182,BUF,2,2,1,0,0,5
2010,21182,NYR,2,0,0,0,0,2
2010,21183,PHI,1,0,1,0,0,2
2010,21183,TOR,0,0,0,0,0,0
2010,21184,MTL,0,2,1,0,0,3
2010,21184,NYI,1,0,2,0,1,4
2010,21185,ATL,0,0,0,0,0,0
2010,21185,NJD,1,1,1,0,0,3
2010,21186,PIT,0,2,1,0,0,3
2010,21186,WSH,1,3,2,0,0,6
2010,21187,CAR,5,2,1,0,0,8
2010,21187,TBL,1,2,2,0,0,5
2010,21188,FLA,0,1,1,0,0,2
2010,21188,OTT,1,2,2,0,0,5
2010,21189,CHI,2,1,2,0,0,5
2010,21189,DAL,0,1,1,0,0,2
2010,21190,CGY,0,0,1,0,0,1
2010,21190,SJS,1,1,0,0,0,2
2010,21191,COL,2,1,0,0,1,4
2010,21191,VAN,1,1,1,0,0,3
2010,21192,ANA,2,2,0,0,0,4
2010,21192,LAK,0,2,2,0,1,5
2010,21193,NYR,3,0,2,0,0,5
2010,21193,TOR,0,0,1,0,0,1
2010,21194,CBJ,2,0,1,0,0,3
2010,21194,DET,1,0,3,0,0,4
2010,21195,CHI,4,2,0,0,0,6
2010,21195,STL,1,1,3,0,0,5
2010,21196,COL,3,0,1,0,0,4
2010,21196,EDM,2,1,1,1,0,5
2010,21197,NSH,1,0,1,0,0,2
2010,21197,PHX,1,1,3,0,0,5
2010,21198,BOS,0,1,2,0,0,3
2010,21198,BUF,1,0,0,0,0,1
2010,21199,MTL,0,1,1,0,0,2
2010,21199,CAR,0,2,3,0,0,5
2010,21200,NYI,2,1,0,0,0,3
2010,21200,PIT,4,2,1,0,0,7
2010,21201,OTT,0,2,1,0,0,3
2010,21201,TBL,2,1,0,0,1,4
2010,21202,FLA,0,1,2,0,0,3
2010,21202,NJD,0,1,1,0,0,2
2010,21203,ANA,0,1,1,0,0,2
2010,21203,DAL,0,1,1,0,1,3
2010,21204,CGY,0,1,0,0,0,1
2010,21204,MIN,1,0,0,0,1,2
2010,21205,LAK,0,1,1,0,0,2
2010,21205,PHX,0,0,2,0,1,3
2010,21206,SJS,1,3,0,0,0,4
2010,21206,VAN,0,0,2,0,0,2
2010,21207,NYR,2,2,0,0,0,4
2010,21207,PHI,1,2,0,0,0,3
2010,21208,ATL,0,2,0,0,0,2
2010,21208,WSH,1,1,3,0,0,5
2010,21209,CBJ,0,0,0,0,0,0
2010,21209,DET,0,0,0,0,1,1
2010,21210,ANA,1,2,0,0,0,3
2010,21210,STL,1,1,4,0,0,6
2010,21211,CHI,2,1,2,0,0,5
2010,21211,COL,0,1,1,0,0,2
2010,21212,BOS,0,3,1,0,0,4
2010,21212,CAR,0,2,0,0,0,2
2010,21213,EDM,1,1,1,0,1,4
2010,21213,LAK,0,0,3,0,0,3
2010,21214,MTL,2,1,0,0,0,3
2010,21214,TOR,1,1,1,1,0,4
2010,21215,BUF,2,2,1,0,0,5
2010,21215,OTT,0,1,1,0,0,2
2010,21216,NJD,3,2,2,0,0,7
2010,21216,NYI,0,0,1,0,0,1
2010,21217,ATL,0,1,0,0,0,1
2010,21217,PIT,0,0,0,0,0,0
2010,21218,FLA,1,1,1,0,0,3
2010,21218,TBL,1,2,0,0,1,4
2010,21219,NSH,0,0,1,0,1,2
2010,21219,STL,0,0,1,0,0,1
2010,21220,DAL,0,2,1,0,1,4
2010,21220,MIN,2,0,1,0,0,3
2010,21221,CGY,1,1,1,0,0,3
2010,21221,VAN,3,1,3,0,0,7
2010,21222,PHX,0,1,1,0,0,2
2010,21222,SJS,1,1,0,0,1,3
2010,21223,NYR,1,0,0,0,0,1
2010,21223,PHI,0,0,1,0,1,2
2010,21224,BOS,2,0,1,0,1,4
2010,21224,WSH,2,0,1,0,0,3
2010,21225,CHI,1,0,1,0,0,2
2010,21225,DET,0,1,1,1,0,3
2010,21226,COL,1,0,0,0,0,1
2010,21226,LAK,0,0,1,1,0,2
2010,21227,BUF,0,1,0,0,0,1
2010,21227,NJD,0,1,1,0,0,2
2010,21228,NYI,1,1,3,0,0,5
2010,21228,PIT,3,2,0,1,0,6
2010,21229,FLA,1,0,0,0,0,1
2010,21229,TBL,2,0,1,0,0,3
2010,21230,ANA,3,1,3,0,0,7
2010,21230,EDM,1,0,1,0,0,2
2011,20001,MTL,1,0,1,0,0,2
2011,20001,TOR,2,0,1,0,0,3
2011,20002,PHI,0,2,1,0,0,3
2011,20002,PIT,0,0,2,0,0,2
2011,20003,CAR,1,3,0,0,0,4
2011,20003,MIN,1,1,1,0,0,3
2011,20004,CHI,1,1,1,0,0,3
2011,20004,COL,1,2,0,1,0,4
2011,20005,CGY,0,0,0,0,0,0
2011,20005,EDM,1,0,3,0,0,4
2011,20006,CBJ,2,0,0,0,0,2
2011,20006,SJS,2,0,1,0,0,3
2011,20007,DAL,1,2,0,1,0,4
2011,20007,NJD,2,1,0,0,0,3
2011,20008,CAR,0,1,0,0,1,2
2011,20008,MIN,1,0,0,0,0,1
2011,20009,ANA,0,0,0,0,0,0
2011,20009,DET,2,2,0,0,0,4
2011,20010,BUF,1,0,1,0,0,2
2011,20010,OTT,0,1,0,0,0,1
2011,20011,ATL,1,2,1,0,0,4
2011,20011,WSH,1,0,1,0,0,2
2011,20012,BOS,0,0,2,0,0,2
2011,20012,PHX,1,3,1,0,0,5
2011,20013,BUF,0,1,2,0,0,3
2011,20013,NYR,2,2,2,0,0,6
2011,20014,OTT,0,0,1,0,0,1
2011,20014,TOR,2,1,2,0,0,5
2011,20015,DAL,2,1,1,0,1,5
2011,20015,NYI,0,2,2,0,0,4
2011,20016,MTL,1,0,2,0,0,3
2011,20016,PIT,0,1,1,0,0,2
2011,20017,NJD,2,0,0,0,0,2
2011,20017,WSH,1,4,2,0,0,7
2011,20018,ATL,0,2,1,0,0,3
2011,20018,TBL,2,2,1,0,0,5
2011,20019,PHI,0,0,1,0,0,1
2011,20019,STL,1,0,0,1,0,2
2011,20020,ANA,0,1,0,0,0,1
2011,20020,NSH,0,3,1,0,0,4
2011,20021,CHI,1,1,0,0,0,2
2011,20021,DET,1,1,1,0,0,3
2011,20022,CBJ,1,0,1,1,0,3
2011,20022,SJS,1,0,1,0,0,2
2011,20023,LAK,0,0,1,0,1,2
2011,20023,VAN,0,1,0,0,0,1
2011,20024,BOS,0,2,1,0,0,3
2011,20024,PHX,0,0,0,0,0,0
2011,20025,CGY,0,1,2,0,0,3
2011,20025,LAK,0,0,1,0,0,1
2011,20026,EDM,0,3,0,0,0,3
2011,20026,FLA,0,2,0,0,0,2
2011,20027,NJD,0,0,1,0,0,1
2011,20027,PIT,1,1,1,0,0,3
2011,20028,NYI,2,1,3,0,0,6
2011,20028,NYR,1,2,1,0,0,4
2011,20029,ANA,0,1,0,0,0,1
2011,20029,STL,2,2,1,0,0,5
2011,20030,BUF,2,0,1,0,0,3
2011,20030,CHI,1,2,1,0,0,4
2011,20031,COL,0,1,1,0,0,2
2011,20031,PHI,2,0,2,0,0,4
2011,20032,OTT,0,1,1,0,0,2
2011,20032,WSH,1,1,0,1,0,3
2011,20033,FLA,0,1,0,0,0,1
2011,20033,VAN,1,0,1,0,0,2
2011,20034,COL,1,1,2,0,1,5
2011,20034,DET,1,2,1,0,0,4
2011,20035,ATL,0,1,0,0,0,1
2011,20035,LAK,0,0,3,0,0,3
2011,20036,BUF,0,0,0,0,0,0
2011,20036,NJD,0,0,0,1,0,1
2011,20037,NYI,1,0,0,0,0,1
2011,20037,WSH,0,1,1,0,0,2
2011,20038,MTL,2,0,1,0,0,3
2011,20038,TBL,0,1,2,1,0,4
2011,20039,PIT,2,1,0,0,0,3
2011,20039,TOR,1,3,0,0,0,4
2011,20040,CHI,2,0,0,0,0,2
2011,20040,NSH,1,0,2,0,0,3
2011,20041,ANA,1,1,2,0,0,4
2011,20041,VAN,2,0,1,0,0,3
2011,20042,PHI,1,0,1,0,0,2
2011,20042,TBL,1,1,1,0,0,3
2011,20043,CAR,0,0,2,0,0,2
2011,20043,OTT,1,1,1,0,0,3
2011,20044,NSH,3,1,0,0,0,4
2011,20044,STL,1,1,1,0,0,3
2011,20045,EDM,0,2,0,0,0,2
2011,20045,MIN,1,2,1,0,0,4
2011,20046,DAL,1,3,0,0,0,4
2011,20046,DET,0,0,1,0,0,1
2011,20047,CGY,0,0,0,0,0,0
2011,20047,FLA,2,0,1,0,0,3
2011,20048,COL,1,1,1,0,0,3
2011,20048,NJD,0,1,1,0,0,2
2011,20049,NYR,1,0,2,0,0,3
2011,20049,TOR,0,3,0,1,0,4
2011,20050,NYI,0,2,0,0,0,2
2011,20050,PIT,0,2,0,1,0,3
2011,20051,CHI,2,2,1,0,0,5
2011,20051,CBJ,0,1,1,0,0,2
2011,20052,BUF,0,0,1,0,0,1
2011,20052,MTL,0,2,0,0,0,2
2011,20053,ANA,1,2,1,0,0,4
2011,20053,ATL,1,1,2,0,1,5
2011,20054,LAK,1,1,2,0,0,4
2011,20054,VAN,0,0,1,0,0,1
2011,20055,MTL,1,2,1,0,0,4
2011,20055,OTT,1,2,0,0,0,3
2011,20056,BOS,0,4,0,0,0,4
2011,20056,NJD,0,1,0,0,0,1
2011,20057,COL,0,0,2,0,0,2
2011,20057,NYI,0,3,2,0,0,5
2011,20058,PHI,1,0,0,0,0,1
2011,20058,PIT,1,1,3,0,0,5
2011,20059,FLA,4,0,2,0,0,6
2011,20059,TBL,0,0,0,0,0,0
2011,20060,NSH,1,1,0,0,0,2
2011,20060,WSH,0,0,2,1,0,3
2011,20061,CBJ,1,1,1,0,0,3
2011,20061,MIN,0,2,0,0,0,2
2011,20062,DAL,1,1,0,0,1,3
2011,20062,STL,2,0,0,0,0,2
2011,20063,BUF,2,1,0,0,0,3
2011,20063,CHI,1,1,2,0,0,4
2011,20064,DET,0,1,0,1,0,2
2011,20064,PHX,1,0,0,0,0,1
2011,20065,CGY,1,1,3,0,0,5
2011,20065,EDM,1,2,0,0,0,3
2011,20066,ATL,0,2,2,0,0,4
2011,20066,SJS,2,0,0,0,0,2
2011,20067,ANA,0,2,1,0,0,3
2011,20067,PHX,0,0,2,0,0,2
2011,20068,CAR,0,1,0,0,0,1
2011,20068,VAN,2,1,2,0,0,5
2011,20069,NYI,0,1,0,1,0,2
2011,20069,TOR,0,0,1,0,0,1
2011,20070,COL,1,0,2,0,0,3
2011,20070,NYR,1,0,0,0,0,1
2011,20071,OTT,0,1,1,0,0,2
2011,20071,PIT,3,2,0,0,0,5
2011,20072,DAL,1,1,2,0,0,4
2011,20072,TBL,2,2,1,0,0,5
2011,20073,CHI,0,0,2,1,0,3
2011,20073,STL,0,1,1,0,0,2
2011,20074,BOS,2,0,1,0,0,3
2011,20074,WSH,0,1,0,0,0,1
2011,20075,CGY,0,0,0,1,0,1
2011,20075,NSH,0,0,0,0,0,0
2011,20076,MIN,3,3,0,0,0,6
2011,20076,VAN,1,0,1,0,0,2
2011,20077,CAR,2,1,2,0,0,5
2011,20077,SJS,0,2,0,0,0,2
2011,20078,ATL,0,0,1,0,0,1
2011,20078,BUF,1,2,1,0,0,4
2011,20079,ANA,0,0,1,0,0,1
2011,20079,CBJ,0,2,1,0,0,3
2011,20080,CHI,1,0,0,0,1,2
2011,20080,VAN,0,0,1,0,0,1
2011,20081,CAR,2,1,0,0,0,3
2011,20081,LAK,2,1,1,0,0,4
2011,20082,BOS,1,2,1,0,0,4
2011,20082,WSH,0,0,1,0,0,1
2011,20083,NYR,2,0,0,0,0,2
2011,20083,TOR,0,0,1,0,0,1
2011,20084,ANA,2,0,1,0,0,3
2011,20084,PHI,1,1,0,0,0,2
2011,20085,CGY,2,0,0,0,0,2
2011,20085,DET,1,1,2,0,0,4
2011,20086,MTL,0,0,0,0,0,0
2011,20086,NJD,1,1,1,0,0,3
2011,20087,NYI,1,1,0,1,0,3
2011,20087,TBL,1,1,0,0,0,2
2011,20088,DAL,2,2,0,0,0,4
2011,20088,FLA,0,0,1,0,0,1
2011,20089,NSH,1,1,1,0,0,3
2011,20089,PIT,0,2,1,1,0,4
2011,20090,COL,1,0,1,0,0,2
2011,20090,SJS,1,2,1,0,0,4
2011,20091,EDM,1,0,1,0,0,2
2011,20091,MIN,3,0,1,0,0,4
2011,20092,LAK,0,1,1,0,0,2
2011,20092,PHX,2,1,1,0,0,4
2011,20093,CGY,3,1,2,0,0,6
2011,20093,CBJ,1,0,1,0,0,2
2011,20094,BUF,1,1,0,0,0,2
2011,20094,OTT,1,2,1,0,0,4
2011,20095,ATL,0,1,1,0,0,2
2011,20095,TBL,3,1,1,0,0,5
2011,20096,CHI,1,1,0,0,0,2
2011,20096,STL,1,1,2,0,0,4
2011,20097,MIN,0,0,1,0,0,1
2011,20097,VAN,1,1,3,0,0,5
2011,20098,BOS,1,1,0,0,0,2
2011,20098,NYR,2,1,0,0,0,3
2011,20099,MTL,1,2,0,0,0,3
2011,20099,OTT,0,0,0,0,0,0
2011,20100,BUF,2,3,1,0,0,6
2011,20100,NJD,0,0,1,0,0,1
2011,20101,PHI,2,1,2,0,0,5
2011,20101,TOR,0,2,0,0,0,2
2011,20102,ATL,1,1,1,0,0,3
2011,20102,WSH,0,1,2,1,0,4
2011,20103,FLA,2,1,1,0,0,4
2011,20103,NYI,1,2,0,0,0,3
2011,20104,ANA,1,2,1,0,0,4
2011,20104,DET,1,2,2,0,0,5
2011,20105,PIT,0,0,0,0,0,0
2011,20105,STL,0,0,0,1,0,1
2011,20106,DAL,0,0,0,0,0,0
2011,20106,NSH,1,0,0,0,0,1
2011,20107,CHI,2,0,0,0,0,2
2011,20107,CBJ,0,1,2,0,0,3
2011,20108,COL,2,1,1,0,0,4
2011,20108,LAK,2,2,2,0,0,6
2011,20109,CAR,0,2,1,1,0,4
2011,20109,PHX,0,0,3,0,0,3
2011,20110,EDM,1,0,0,0,0,1
2011,20110,SJS,1,2,3,0,0,6
2011,20111,NSH,2,1,1,0,0,4
2011,20111,TBL,1,0,2,0,0,3
2011,20112,NJD,0,0,1,0,0,1
2011,20112,NYR,0,2,1,0,0,3
2011,20113,CGY,4,0,0,0,0,4
2011,20113,SJS,0,0,0,0,0,0
2011,20114,CBJ,1,1,0,0,0,2
2011,20114,PHI,0,0,1,0,0,1
2011,20115,MTL,0,2,0,1,0,3
2011,20115,PHX,0,1,1,0,0,2
2011,20116,LAK,1,1,0,0,1,3
2011,20116,MIN,2,0,0,0,0,2
2011,20117,FLA,0,1,0,0,0,1
2011,20117,TOR,1,0,2,0,0,3
2011,20118,BUF,1,0,2,0,0,3
2011,20118,PHI,1,3,2,0,0,6
2011,20119,OTT,3,0,2,0,0,5
2011,20119,PHX,0,1,1,0,0,2
2011,20120,CGY,2,2,0,0,1,5
2011,20120,EDM,1,1,2,0,0,4
2011,20121,ANA,0,3,2,0,0,5
2011,20121,DAL,1,0,1,0,0,2
2011,20122,COL,1,1,1,0,0,3
2011,20122,VAN,1,1,1,1,0,4
2011,20123,ATL,1,2,3,0,0,6
2011,20123,NYR,1,1,2,0,0,4
2011,20124,CAR,0,0,0,0,0,0
2011,20124,WSH,0,0,0,0,0,0
2011,20125,MTL,2,1,2,0,0,5
2011,20125,NYI,1,0,2,0,0,3
2011,20126,PIT,3,0,0,0,0,3
2011,20126,TBL,2,1,2,0,0,5
2011,20127,CHI,1,1,1,0,0,3
2011,20127,LAK,1,0,0,0,0,1
2011,20128,NJD,0,1,1,0,0,2
2011,20128,SJS,3,1,1,0,0,5
2011,20129,BOS,1,1,0,0,0,2
2011,20129,TOR,0,0,0,0,0,0
2011,20130,DET,0,1,1,0,0,2
2011,20130,PHX,3,0,1,0,0,4
2011,20131,CBJ,2,0,0,0,1,3
2011,20131,EDM,1,0,1,0,0,2
2011,20132,FLA,1,0,2,0,0,3
2011,20132,OTT,0,3,2,0,0,5
2011,20133,NSH,0,0,0,0,0,0
2011,20133,STL,0,1,2,0,0,3
2011,20134,MIN,1,1,0,0,0,2
2011,20134,WSH,0,0,1,0,0,1
2011,20135,DAL,1,0,1,0,0,2
2011,20135,LAK,1,2,2,0,0,5
2011,20136,CGY,2,2,1,0,0,5
2011,20136,COL,1,2,3,0,0,6
2011,20137,MTL,1,0,2,0,0,3
2011,20137,NYI,0,1,0,0,0,1
2011,20138,CAR,1,2,1,0,0,4
2011,20138,NYR,0,3,0,0,0,3
2011,20139,PHI,0,2,1,0,0,3
2011,20139,PIT,1,0,1,0,0,2
2011,20140,ATL,0,2,1,1,0,4
2011,20140,BUF,2,0,1,0,0,3
2011,20141,CHI,2,1,1,0,0,4
2011,20141,EDM,4,2,1,0,0,7
2011,20142,ANA,0,1,0,0,0,1
2011,20142,NJD,0,1,1,0,0,2
2011,20143,NYR,1,1,0,0,0,2
2011,20143,TOR,0,0,0,0,0,0
2011,20144,FLA,1,1,1,0,0,3
2011,20144,MTL,0,1,0,0,0,1
2011,20145,BOS,1,2,1,0,0,4
2011,20145,OTT,0,0,0,0,0,0
2011,20146,NYI,0,1,0,0,0,1
2011,20146,PHI,2,4,0,0,0,6
2011,20147,CAR,0,0,0,0,0,0
2011,20147,PIT,1,1,1,0,0,3
2011,20148,DET,2,1,2,0,0,5
2011,20148,NSH,0,1,1,0,0,2
2011,20149,ATL,3,0,0,0,0,3
2011,20149,STL,1,0,2,0,1,4
2011,20150,CHI,0,1,2,0,0,3
2011,20150,MIN,0,0,1,0,0,1
2011,20151,BUF,0,0,0,0,0,0
2011,20151,DAL,1,1,2,0,0,4
2011,20152,COL,1,3,1,0,0,5
2011,20152,CBJ,0,0,1,0,0,1
2011,20153,PHX,0,0,0,0,0,0
2011,20153,TBL,0,1,2,0,0,3
2011,20154,CGY,2,0,0,0,0,2
2011,20154,WSH,1,6,0,0,0,7
2011,20155,LAK,1,2,0,0,0,3
2011,20155,NJD,0,1,0,0,0,1
2011,20156,ANA,0,0,2,0,0,2
2011,20156,SJS,2,3,0,0,0,5
2011,20157,CHI,1,0,1,0,0,2
2011,20157,NYR,1,0,2,0,0,3
2011,20158,CAR,0,1,1,0,0,2
2011,20158,PHI,1,1,1,0,0,3
2011,20159,NJD,0,0,0,0,0,0
2011,20159,VAN,1,1,1,0,0,3
2011,20160,OTT,1,2,0,0,0,3
2011,20160,TOR,0,0,2,0,0,2
2011,20161,CBJ,2,0,1,0,0,3
2011,20161,MTL,0,0,0,0,0,0
2011,20162,MIN,0,1,0,0,0,1
2011,20162,SJS,0,0,0,0,0,0
2011,20163,EDM,0,1,2,0,0,3
2011,20163,VAN,3,0,1,0,0,4
2011,20164,BOS,3,1,1,0,0,5
2011,20164,BUF,0,1,1,0,0,2
2011,20165,TOR,1,0,3,0,0,4
2011,20165,WSH,0,3,1,0,1,5
2011,20166,CAR,3,2,2,0,0,7
2011,20166,NYI,0,0,2,0,0,2
2011,20167,ATL,1,1,2,0,0,4
2011,20167,FLA,1,1,1,0,0,3
2011,20168,CHI,0,1,2,0,0,3
2011,20168,NJD,1,1,3,0,0,5
2011,20169,DAL,2,2,1,0,0,5
2011,20169,PIT,0,1,1,0,0,2
2011,20170,CGY,1,0,0,0,0,1
2011,20170,DET,0,2,0,0,0,2
2011,20171,NSH,2,1,0,0,0,3
2011,20171,PHX,1,1,2,0,0,4
2011,20172,ANA,1,0,1,1,0,3
2011,20172,TBL,0,1,1,0,0,2
2011,20173,NYR,0,1,0,0,0,1
2011,20173,PHI,0,3,1,0,0,4
2011,20174,ATL,0,0,0,0,0,0
2011,20174,CBJ,0,1,2,0,0,3
2011,20175,NYI,0,0,1,0,0,1
2011,20175,OTT,1,2,1,0,0,4
2011,20176,SJS,0,0,0,0,0,0
2011,20176,STL,1,1,0,0,0,2
2011,20177,COL,0,0,1,0,0,1
2011,20177,VAN,1,1,1,0,0,3
2011,20178,LAK,0,0,1,0,0,1
2011,20178,TBL,0,0,0,0,0,0
2011,20179,NJD,0,0,0,0,0,0
2011,20179,NYR,1,1,1,0,0,3
2011,20180,BOS,0,0,3,0,0,3
2011,20180,WSH,0,3,2,0,0,5
2011,20181,BUF,1,1,0,0,0,2
2011,20181,MTL,1,2,0,0,0,3
2011,20182,CAR,3,0,1,0,0,4
2011,20182,FLA,3,1,3,0,0,7
2011,20183,CGY,1,0,0,0,0,1
2011,20183,MIN,1,0,1,0,0,2
2011,20184,DAL,1,4,1,0,0,6
2011,20184,PHX,0,1,2,0,0,3
2011,20185,DET,1,1,1,0,0,3
2011,20185,EDM,0,1,0,0,0,1
2011,20186,ANA,0,3,0,0,0,3
2011,20186,PIT,0,1,1,0,0,2
2011,20187,LAK,2,2,0,0,0,4
2011,20187,NSH,0,0,1,0,0,1
2011,20188,BOS,0,0,1,0,0,1
2011,20188,STL,1,0,0,0,1,2
2011,20189,BUF,0,1,1,0,1,3
2011,20189,TOR,1,1,0,0,0,2
2011,20190,MTL,0,1,1,0,0,2
2011,20190,OTT,1,1,1,0,0,3
2011,20191,NYI,0,1,0,0,0,1
2011,20191,PHI,1,0,1,0,0,2
2011,20192,CAR,0,1,2,0,0,3
2011,20192,FLA,0,0,2,0,0,2
2011,20193,ATL,1,3,0,0,0,4
2011,20193,CHI,2,2,0,0,1,5
2011,20194,CBJ,1,1,0,0,0,2
2011,20194,MIN,1,1,1,0,0,3
2011,20195,COL,1,2,2,0,0,5
2011,20195,DAL,0,0,0,0,0,0
2011,20196,PHX,2,1,0,0,0,3
2011,20196,PIT,0,3,0,0,1,4
2011,20197,DET,0,3,1,0,0,4
2011,20197,VAN,1,2,3,0,0,6
2011,20198,SJS,2,2,1,0,0,5
2011,20198,TBL,1,0,1,0,0,2
2011,20199,PHI,1,1,0,0,0,2
2011,20199,WSH,1,1,0,1,0,3
2011,20200,NYR,0,0,0,0,0,0
2011,20200,STL,0,1,1,0,0,2
2011,20201,CHI,1,0,0,0,0,1
2011,20201,EDM,0,0,2,0,0,2
2011,20202,ANA,2,0,3,0,0,5
2011,20202,NSH,2,0,2,0,0,4
2011,20203,DET,1,0,1,1,0,3
2011,20203,PHX,1,1,0,0,0,2
2011,20204,NYR,2,1,0,0,0,3
2011,20204,WSH,1,2,2,0,0,5
2011,20205,CAR,4,1,2,0,0,7
2011,20205,EDM,0,0,1,0,0,1
2011,20206,MTL,1,0,1,0,0,2
2011,20206,VAN,0,0,0,0,0,0
2011,20207,ATL,1,0,1,0,0,2
2011,20207,OTT,2,2,1,0,0,5
2011,20208,TBL,3,0,1,0,0,4
2011,20208,TOR,0,0,0,0,0,0
2011,20209,CGY,0,1,3,0,0,4
2011,20209,COL,1,0,1,0,0,2
2011,20210,ANA,1,1,0,1,0,3
2011,20210,SJS,1,0,1,0,0,2
2011,20211,BUF,0,3,1,0,1,5
2011,20211,NJD,1,3,0,0,0,4
2011,20212,BOS,2,0,5,0,0,7
2011,20212,PIT,2,2,0,0,0,4
2011,20213,CBJ,3,3,2,0,0,8
2011,20213,STL,0,1,0,0,0,1
2011,20214,FLA,1,1,2,0,0,4
2011,20214,TOR,0,0,1,0,0,1
2011,20215,CHI,1,0,0,0,0,1
2011,20215,PHX,0,2,0,0,0,2
2011,20216,ANA,0,0,1,0,0,1
2011,20216,NYI,0,0,0,0,0,0
2011,20217,BOS,1,0,0,0,0,1
2011,20217,MTL,1,0,2,0,0,3
2011,20218,BUF,0,2,0,0,0,2
2011,20218,NYR,1,1,0,1,0,3
2011,20219,TBL,1,0,2,0,0,3
2011,20219,WSH,0,2,4,0,0,6
2011,20220,CAR,0,0,1,0,0,1
2011,20220,PHI,2,2,4,0,0,8
2011,20221,ATL,2,1,2,0,0,5
2011,20221,MIN,0,0,1,0,0,1
2011,20222,DET,3,2,1,0,0,6
2011,20222,EDM,0,0,2,0,0,2
2011,20223,OTT,1,0,1,0,0,2
2011,20223,VAN,1,1,4,0,0,6
2011,20224,NSH,0,1,1,0,1,3
2011,20224,STL,1,0,1,0,0,2
2011,20225,DAL,1,0,0,0,0,1
2011,20225,LAK,1,0,2,0,0,3
2011,20226,NYI,0,1,0,0,0,1
2011,20226,SJS,0,1,0,0,1,2
2011,20227,EDM,2,1,0,0,0,3
2011,20227,NJD,1,1,1,1,0,4
2011,20228,PIT,0,2,3,0,0,5
2011,20228,TBL,0,0,1,0,0,1
2011,20229,COL,1,3,1,0,0,5
2011,20229,CBJ,1,0,0,0,0,1
2011,20230,FLA,2,0,0,0,0,2
2011,20230,MIN,1,0,0,0,0,1
2011,20231,CGY,1,1,2,0,0,4
2011,20231,PHX,0,3,2,0,0,5
2011,20232,ANA,1,0,3,0,0,4
2011,20232,DAL,1,0,1,0,0,2
2011,20233,BOS,0,0,0,0,0,0
2011,20233,OTT,1,0,1,0,0,2
2011,20234,BUF,0,2,0,1,0,3
2011,20234,WSH,1,0,1,0,0,2
2011,20235,TOR,2,1,0,0,0,3
2011,20235,VAN,2,1,2,0,0,5
2011,20236,CAR,0,2,0,0,0,2
2011,20236,MTL,2,3,2,0,0,7
2011,20237,FLA,0,1,1,0,0,2
2011,20237,PHI,2,3,0,0,0,5
2011,20238,ATL,1,0,1,0,0,2
2011,20238,PIT,0,1,3,0,0,4
2011,20239,COL,0,0,1,0,0,1
2011,20239,DET,1,2,0,0,0,3
2011,20240,CHI,1,2,0,0,0,3
2011,20240,NSH,0,2,1,0,1,4
2011,20241,PHX,1,3,1,0,0,5
2011,20241,STL,1,1,1,0,0,3
2011,20242,CGY,0,1,2,0,0,3
2011,20242,SJS,2,1,1,0,0,4
2011,20243,LAK,2,1,2,0,0,5
2011,20243,NYI,1,0,0,0,0,1
2011,20244,EDM,0,2,0,0,0,2
2011,20244,NYR,1,4,3,0,0,8
2011,20245,ATL,1,3,0,0,0,4
2011,20245,WSH,3,1,2,0,0,6
2011,20246,MIN,3,0,1,0,0,4
2011,20246,TBL,1,0,0,0,0,1
2011,20247,ANA,1,0,1,0,0,2
2011,20247,CHI,1,1,0,1,0,3
2011,20248,BOS,1,1,1,0,0,3
2011,20248,NJD,0,0,0,0,0,0
2011,20249,BUF,2,1,0,1,0,4
2011,20249,VAN,0,1,2,0,0,3
2011,20250,OTT,1,0,0,0,0,1
2011,20250,PHI,2,1,2,0,0,5
2011,20251,NYR,0,1,1,1,0,3
2011,20251,PIT,0,0,2,0,0,2
2011,20252,COL,3,2,1,0,0,6
2011,20252,STL,1,1,1,0,0,3
2011,20253,LAK,1,1,1,0,0,3
2011,20253,SJS,2,1,3,0,0,6
2011,20254,NSH,3,1,0,0,0,4
2011,20254,TOR,1,4,0,0,0,5
2011,20255,MTL,1,1,1,0,0,3
2011,20255,PHI,0,0,0,0,0,0
2011,20256,ANA,0,1,0,0,0,1
2011,20256,DAL,1,0,1,0,0,2
2011,20257,NYI,0,1,1,0,0,2
2011,20257,TBL,1,1,2,0,0,4
2011,20258,BOS,0,2,1,0,0,3
2011,20258,NYR,0,1,1,0,0,2
2011,20259,PIT,1,2,0,0,0,3
2011,20259,VAN,0,1,0,0,0,1
2011,20260,BUF,0,2,0,0,0,2
2011,20260,WSH,2,1,1,0,0,4
2011,20261,CAR,4,0,3,0,0,7
2011,20261,OTT,0,0,1,0,0,1
2011,20262,ATL,1,0,0,0,0,1
2011,20262,FLA,0,2,0,0,0,2
2011,20263,DET,1,2,4,0,0,7
2011,20263,STL,1,2,0,0,0,3
2011,20264,ANA,0,1,0,0,0,1
2011,20264,MIN,0,1,0,1,0,2
2011,20265,COL,1,0,2,1,0,4
2011,20265,SJS,1,2,0,0,0,3
2011,20266,CGY,0,0,1,0,0,1
2011,20266,PHX,0,2,1,0,0,3
2011,20267,CHI,2,2,1,0,0,5
2011,20267,EDM,0,0,0,0,0,0
2011,20268,CBJ,1,1,3,0,0,5
2011,20268,LAK,1,1,1,0,0,3
2011,20269,BOS,1,0,3,0,0,4
2011,20269,FLA,0,0,0,0,0,0
2011,20270,NJD,0,1,0,0,0,1
2011,20270,TOR,0,2,1,0,0,3
2011,20271,PHI,5,2,0,0,0,7
2011,20271,TBL,4,3,1,0,0,8
2011,20272,MTL,0,0,0,0,0,0
2011,20272,NSH,0,1,2,0,0,3
2011,20273,DAL,2,0,2,1,0,5
2011,20273,SJS,1,2,1,0,0,4
2011,20274,CAR,2,1,1,0,0,4
2011,20274,PIT,2,1,1,0,1,5
2011,20275,DET,0,1,2,0,0,3
2011,20275,MIN,1,1,1,1,0,4
2011,20276,BUF,0,2,2,0,0,4
2011,20276,LAK,1,1,0,0,0,2
2011,20277,ATL,3,1,1,0,0,5
2011,20277,WSH,0,0,0,0,0,0
2011,20278,OTT,1,0,1,0,0,2
2011,20278,STL,0,3,2,0,0,5
2011,20279,COL,0,4,1,0,0,5
2011,20279,NYR,0,0,1,0,0,1
2011,20280,CGY,2,2,3,0,0,7
2011,20280,CHI,1,0,1,0,0,2
2011,20281,EDM,1,2,0,0,0,3
2011,20281,PHX,0,2,1,0,1,4
2011,20282,ANA,0,2,1,0,0,3
2011,20282,CBJ,1,3,0,0,0,4
2011,20283,BOS,0,2,1,0,0,3
2011,20283,LAK,2,1,0,0,1,4
2011,20284,BUF,1,0,0,0,0,1
2011,20284,TBL,1,1,0,0,0,2
2011,20285,MTL,0,1,1,0,0,2
2011,20285,TOR,0,0,0,0,0,0
2011,20286,FLA,0,4,0,0,0,4
2011,20286,NYI,1,0,0,0,0,1
2011,20287,PHI,0,2,2,0,1,5
2011,20287,WSH,1,0,3,0,0,4
2011,20288,CAR,1,0,0,0,0,1
2011,20288,NSH,0,1,0,0,1,2
2011,20289,NJD,1,1,0,0,0,2
2011,20289,STL,1,1,1,0,0,3
2011,20290,MIN,0,0,2,0,0,2
2011,20290,NYR,0,3,2,0,0,5
2011,20291,COL,1,2,0,0,1,4
2011,20291,DAL,0,2,1,0,0,3
2011,20292,CHI,0,4,3,0,0,7
2011,20292,VAN,0,0,1,0,0,1
2011,20293,CBJ,1,1,1,0,0,3
2011,20293,SJS,0,0,0,0,0,0
2011,20294,ATL,0,0,1,1,0,2
2011,20294,NYI,0,1,0,0,0,1
2011,20295,CGY,1,2,1,0,0,4
2011,20295,DET,1,0,3,1,0,5
2011,20296,ANA,0,2,0,0,0,2
2011,20296,EDM,0,2,2,0,0,4
2011,20297,PHX,0,2,1,0,0,3
2011,20297,VAN,0,2,0,0,0,2
2011,20298,DAL,0,1,0,0,0,1
2011,20298,TOR,1,2,1,0,0,4
2011,20299,NJD,3,2,0,0,0,5
2011,20299,WSH,0,0,0,0,0,0
2011,20300,CGY,0,1,0,0,0,1
2011,20300,NYR,0,2,0,0,0,2
2011,20301,MTL,2,0,0,0,0,2
2011,20301,PHI,0,1,2,0,0,3
2011,20302,CBJ,1,1,0,0,0,2
2011,20302,NSH,0,0,0,0,0,0
2011,20303,LAK,1,1,0,0,0,2
2011,20303,OTT,1,1,1,0,0,3
2011,20304,BOS,0,0,1,0,0,1
2011,20304,TBL,0,3,0,0,0,3
2011,20305,FLA,1,1,0,0,0,2
2011,20305,PIT,2,0,1,0,0,3
2011,20306,EDM,0,0,0,0,0,0
2011,20306,PHX,1,2,2,0,0,5
2011,20307,BUF,0,0,0,0,0,0
2011,20307,PIT,1,0,0,0,0,1
2011,20308,CBJ,2,1,0,1,0,4
2011,20308,NYI,1,2,0,0,0,3
2011,20309,CAR,0,0,2,0,0,2
2011,20309,WSH,1,1,1,0,0,3
2011,20310,ATL,2,2,1,0,0,5
2011,20310,DET,1,0,0,0,0,1
2011,20311,LAK,0,1,0,0,0,1
2011,20311,MTL,2,2,0,0,0,4
2011,20312,DAL,0,1,1,0,0,2
2011,20312,OTT,0,1,0,0,0,1
2011,20313,CGY,0,0,1,0,0,1
2011,20313,NJD,1,0,0,0,1,2
2011,20314,NYR,0,0,3,0,0,3
2011,20314,TBL,2,3,0,0,0,5
2011,20315,BOS,0,0,3,0,0,3
2011,20315,FLA,0,1,0,0,0,1
2011,20316,NSH,0,1,0,0,0,1
2011,20316,STL,1,0,0,0,1,2
2011,20317,MIN,0,1,0,0,0,1
2011,20317,PHI,2,1,3,0,0,6
2011,20318,COL,0,1,1,0,0,2
2011,20318,VAN,1,1,2,0,0,4
2011,20319,CHI,0,1,1,0,0,2
2011,20319,SJS,1,2,2,0,0,5
2011,20320,COL,1,1,0,0,0,2
2011,20320,EDM,2,0,1,0,0,3
2011,20321,BOS,0,0,0,0,0,0
2011,20321,CAR,1,1,1,0,0,3
2011,20322,NJD,0,0,0,0,0,0
2011,20322,NYI,1,1,0,0,0,2
2011,20323,CGY,0,1,1,0,1,3
2011,20323,PHI,0,2,0,0,0,2
2011,20324,OTT,1,0,0,0,0,1
2011,20324,PIT,0,1,1,0,0,2
2011,20325,MIN,3,1,1,0,0,5
2011,20325,NSH,0,0,2,0,0,2
2011,20326,ANA,1,0,0,0,0,1
2011,20326,CHI,0,1,3,0,0,4
2011,20327,TBL,0,0,0,0,0,0
2011,20327,WSH,1,4,1,0,0,6
2011,20328,CBJ,0,0,1,0,0,1
2011,20328,DET,0,1,1,0,0,2
2011,20329,BUF,2,0,1,0,0,3
2011,20329,TOR,0,0,1,0,0,1
2011,20330,ATL,1,2,0,0,0,3
2011,20330,MTL,0,0,0,0,0,0
2011,20331,FLA,0,0,0,0,0,0
2011,20331,NYR,1,0,2,0,0,3
2011,20332,DAL,0,1,2,0,0,3
2011,20332,STL,1,1,0,0,0,2
2011,20333,SJS,1,0,0,0,0,1
2011,20333,VAN,1,2,3,0,0,6
2011,20334,NJD,1,0,0,0,1,2
2011,20334,PHI,0,0,1,0,0,1
2011,20335,CGY,0,0,1,0,0,1
2011,20335,PIT,0,2,2,0,0,4
2011,20336,BUF,0,0,1,0,0,1
2011,20336,MTL,1,2,0,0,0,3
2011,20337,OTT,1,2,0,0,0,3
2011,20337,TOR,0,0,0,0,0,0
2011,20338,FLA,0,1,2,0,1,4
2011,20338,TBL,1,1,1,0,0,3
2011,20339,DAL,0,0,2,0,0,2
2011,20339,STL,0,1,0,0,0,1
2011,20340,NSH,1,0,0,0,0,1
2011,20340,NYR,0,0,1,0,1,2
2011,20341,ANA,1,2,3,0,0,6
2011,20341,PHX,1,2,1,0,0,4
2011,20342,COL,1,4,2,0,0,7
2011,20342,MIN,2,1,1,0,0,4
2011,20343,EDM,1,0,2,0,0,3
2011,20343,SJS,1,2,1,0,0,4
2011,20344,CHI,0,1,1,0,0,2
2011,20344,LAK,0,0,1,0,0,1
2011,20345,CAR,0,1,1,0,0,2
2011,20345,WSH,2,0,0,0,1,3
2011,20346,ATL,3,1,0,0,0,4
2011,20346,BOS,0,1,0,0,0,1
2011,20347,CBJ,1,0,1,0,0,2
2011,20347,DET,0,2,2,0,0,4
2011,20348,NYR,0,1,0,0,0,1
2011,20348,PIT,1,2,0,0,0,3
2011,20349,CAR,0,1,0,0,0,1
2011,20349,DAL,1,2,1,0,0,4
2011,20350,EDM,0,1,3,0,0,4
2011,20350,OTT,1,0,0,0,0,1
2011,20351,CGY,0,2,1,0,0,3
2011,20351,MIN,0,0,0,0,0,0
2011,20352,ANA,0,1,1,0,0,2
2011,20352,LAK,0,0,0,0,0,0
2011,20353,TBL,0,1,2,1,0,4
2011,20353,TOR,1,1,1,0,0,3
2011,20354,NSH,1,1,1,0,0,3
2011,20354,PHX,0,0,0,0,0,0
2011,20355,CHI,2,3,2,0,0,7
2011,20355,STL,1,1,3,0,0,5
2011,20356,ATL,1,0,1,1,0,3
2011,20356,COL,0,0,2,0,0,2
2011,20357,DET,2,2,1,0,0,5
2011,20357,SJS,1,1,1,0,0,3
2011,20358,EDM,1,0,2,1,0,4
2011,20358,MTL,1,2,0,0,0,3
2011,20359,BOS,2,0,1,0,0,3
2011,20359,PHI,0,0,0,0,0,0
2011,20360,CBJ,0,1,2,0,0,3
2011,20360,NSH,1,1,1,0,1,4
2011,20361,STL,0,1,0,0,0,1
2011,20361,WSH,1,1,2,0,0,4
2011,20362,MIN,0,0,2,0,0,2
2011,20362,PHX,1,1,2,0,0,4
2011,20363,CGY,1,1,0,0,0,2
2011,20363,VAN,2,1,4,0,0,7
2011,20364,ANA,1,2,2,0,0,5
2011,20364,FLA,0,1,2,0,0,3
2011,20365,BOS,2,2,4,0,0,8
2011,20365,TBL,0,1,0,0,0,1
2011,20366,EDM,1,2,2,0,0,5
2011,20366,TOR,0,0,0,0,0,0
2011,20367,MTL,2,3,0,0,0,5
2011,20367,NJD,0,0,1,0,0,1
2011,20368,NYI,1,2,2,0,0,5
2011,20368,NYR,2,2,2,0,0,6
2011,20369,ATL,1,1,0,0,0,2
2011,20369,PIT,1,2,0,0,0,3
2011,20370,OTT,0,0,0,0,0,0
2011,20370,SJS,1,1,2,0,0,4
2011,20371,DAL,0,1,1,0,0,2
2011,20371,WSH,0,0,1,0,0,1
2011,20372,FLA,1,1,0,0,0,2
2011,20372,LAK,1,0,2,0,0,3
2011,20373,NYI,0,0,0,0,0,0
2011,20373,NYR,0,1,1,0,0,2
2011,20374,CAR,0,0,1,1,0,2
2011,20374,COL,0,0,1,0,0,1
2011,20375,BUF,2,1,2,0,0,5
2011,20375,CBJ,0,0,0,0,0,0
2011,20376,CGY,0,1,1,0,1,3
2011,20376,MIN,0,1,1,0,0,2
2011,20377,CHI,0,0,0,0,0,0
2011,20377,VAN,0,1,2,0,0,3
2011,20378,ANA,0,0,0,0,0,0
2011,20378,DET,1,2,1,0,0,4
2011,20379,NJD,2,0,1,0,0,3
2011,20379,PHI,1,1,3,0,0,5
2011,20380,MTL,1,1,1,0,0,3
2011,20380,SJS,1,0,0,0,0,1
2011,20381,BOS,1,0,1,0,0,2
2011,20381,TOR,1,0,1,0,1,3
2011,20382,BUF,0,0,0,0,1,1
2011,20382,OTT,0,0,0,0,0,0
2011,20383,ATL,0,2,1,0,0,3
2011,20383,WSH,0,1,0,0,0,1
2011,20384,CBJ,0,1,1,0,0,2
2011,20384,PIT,4,3,0,0,0,7
2011,20385,COL,1,1,3,0,0,5
2011,20385,TBL,1,3,2,0,0,6
2011,20386,CAR,1,1,0,0,0,2
2011,20386,NSH,3,0,2,0,0,5
2011,20387,DAL,1,1,1,1,0,4
2011,20387,MIN,0,1,2,0,0,3
2011,20388,FLA,0,1,0,0,1,2
2011,20388,PHX,0,1,0,0,0,1
2011,20389,EDM,0,0,1,1,0,2
2011,20389,STL,0,0,1,0,0,1
2011,20390,DET,1,1,0,0,0,2
2011,20390,LAK,0,2,0,1,0,3
2011,20391,NYI,0,0,2,0,0,2
2011,20391,PHI,1,0,2,0,0,3
2011,20392,NYR,0,1,0,0,0,1
2011,20392,OTT,0,1,2,0,0,3
2011,20393,CGY,2,0,0,0,0,2
2011,20393,CHI,3,0,1,0,0,4
2011,20394,ANA,0,0,0,0,0,0
2011,20394,PHX,1,1,1,0,0,3
2011,20395,STL,1,1,1,0,0,3
2011,20395,VAN,1,1,0,0,0,2
2011,20396,NJD,1,0,0,0,0,1
2011,20396,PIT,1,1,0,0,0,2
2011,20397,TOR,1,0,3,0,1,5
2011,20397,WSH,2,2,0,0,0,4
2011,20398,ATL,0,1,1,1,0,3
2011,20398,NSH,2,0,0,0,0,2
2011,20399,DET,2,0,0,0,0,2
2011,20399,SJS,1,3,1,0,0,5
2011,20400,CBJ,1,0,1,0,1,3
2011,20400,DAL,0,1,1,0,0,2
2011,20401,BOS,1,0,1,1,0,3
2011,20401,BUF,0,1,1,0,0,2
2011,20402,MTL,1,0,3,0,0,4
2011,20402,OTT,1,0,0,0,0,1
2011,20403,COL,0,2,1,0,0,3
2011,20403,FLA,1,1,1,1,0,4
2011,20404,CGY,2,1,1,0,0,4
2011,20404,TBL,0,2,0,0,0,2
2011,20405,ANA,0,1,1,0,1,3
2011,20405,EDM,0,0,2,0,0,2
2011,20406,PHI,0,3,1,0,0,4
2011,20406,SJS,1,0,3,0,1,5
2011,20407,PIT,1,3,1,0,0,5
2011,20407,TOR,0,0,2,0,0,2
2011,20408,DET,0,1,1,0,0,2
2011,20408,NSH,1,1,1,0,0,3
2011,20409,CHI,2,2,1,0,0,5
2011,20409,DAL,0,3,0,0,0,3
2011,20410,ANA,1,2,1,0,0,4
2011,20410,VAN,2,0,2,0,1,5
2011,20411,BOS,1,1,3,0,0,5
2011,20411,NYI,0,1,1,0,0,2
2011,20412,BUF,1,2,3,0,0,6
2011,20412,SJS,0,2,1,0,0,3
2011,20413,PHI,2,2,0,0,0,4
2011,20413,TOR,0,1,0,0,0,1
2011,20414,FLA,0,1,2,0,0,3
2011,20414,WSH,0,0,0,0,0,0
2011,20415,NYR,1,1,3,0,0,5
2011,20415,OTT,1,2,0,0,0,3
2011,20416,CBJ,0,0,1,0,0,1
2011,20416,STL,2,1,1,0,0,4
2011,20417,MIN,2,0,1,0,0,3
2011,20417,PHX,1,0,1,0,0,2
2011,20418,CGY,0,0,1,0,0,1
2011,20418,LAK,1,0,1,0,0,2
2011,20419,DET,1,2,1,0,0,4
2011,20419,MTL,1,0,1,0,0,2
2011,20420,NJD,0,2,0,0,0,2
2011,20420,OTT,1,2,0,0,0,3
2011,20421,ATL,1,1,0,0,0,2
2011,20421,COL,0,2,2,0,0,4
2011,20422,CAR,0,1,0,0,0,1
2011,20422,DAL,1,0,0,0,1,2
2011,20423,EDM,1,2,0,0,1,4
2011,20423,TBL,2,0,1,0,0,3
2011,20424,ANA,1,1,0,0,1,3
2011,20424,CGY,0,0,2,0,0,2
2011,20425,BOS,0,0,1,0,0,1
2011,20425,PHI,0,1,0,1,0,2
2011,20426,BUF,1,0,1,0,0,2
2011,20426,PIT,2,0,3,0,0,5
2011,20427,MTL,0,1,0,0,0,1
2011,20427,TOR,2,0,1,0,0,3
2011,20428,DET,2,1,1,0,0,4
2011,20428,NJD,0,0,1,0,0,1
2011,20429,ATL,0,0,0,0,0,0
2011,20429,NYI,0,0,0,0,0,0
2011,20430,COL,2,1,0,0,0,3
2011,20430,WSH,1,0,1,0,0,2
2011,20431,CBJ,0,1,2,0,0,3
2011,20431,NYR,0,1,0,0,0,1
2011,20432,CAR,0,0,1,0,1,2
2011,20432,STL,0,0,1,0,0,1
2011,20433,FLA,0,0,0,0,0,0
2011,20433,NSH,2,0,1,0,0,3
2011,20434,DAL,0,1,1,0,0,2
2011,20434,PHX,3,0,2,0,0,5
2011,20435,TBL,1,3,0,1,0,5
2011,20435,VAN,1,1,2,0,0,4
2011,20436,LAK,0,1,1,0,0,2
2011,20436,MIN,1,1,0,1,0,3
2011,20437,CHI,1,0,0,0,0,1
2011,20437,SJS,1,0,0,1,0,2
2011,20438,NYR,1,4,2,0,0,7
2011,20438,WSH,0,0,0,0,0,0
2011,20439,EDM,0,0,1,0,0,1
2011,20439,VAN,1,1,0,0,0,2
2011,20440,ANA,2,3,1,0,0,6
2011,20440,MIN,1,1,0,0,0,2
2011,20441,DET,0,0,0,0,0,0
2011,20441,LAK,1,1,3,0,0,5
2011,20442,ATL,2,1,0,1,0,4
2011,20442,OTT,0,1,2,0,0,3
2011,20443,NSH,1,2,2,0,0,5
2011,20443,NYI,0,0,0,0,0,0
2011,20444,CHI,3,1,1,0,0,5
2011,20444,COL,3,1,3,0,0,7
2011,20445,CGY,2,0,0,1,0,3
2011,20445,CBJ,0,1,1,0,0,2
2011,20446,DAL,1,1,0,0,1,3
2011,20446,SJS,0,2,0,0,0,2
2011,20447,PHI,1,1,1,0,0,3
2011,20447,PIT,0,1,1,0,0,2
2011,20448,EDM,1,0,0,0,0,1
2011,20448,TOR,1,2,1,0,0,4
2011,20449,BOS,1,0,1,0,0,2
2011,20449,BUF,1,0,2,0,0,3
2011,20450,NJD,2,0,1,0,0,3
2011,20450,PHX,0,0,0,0,0,0
2011,20451,NYR,0,0,4,0,0,4
2011,20451,PIT,1,0,0,0,0,1
2011,20452,ANA,0,1,0,1,0,2
2011,20452,WSH,1,0,0,0,0,1
2011,20453,DET,0,3,2,0,0,5
2011,20453,STL,0,1,1,0,0,2
2011,20454,MTL,0,1,2,0,0,3
2011,20454,PHI,1,1,3,0,0,5
2011,20455,ATL,1,0,0,0,0,1
2011,20455,TBL,0,1,0,0,1,2
2011,20456,CAR,0,1,3,0,0,4
2011,20456,FLA,3,0,0,0,0,3
2011,20457,NSH,0,1,2,0,0,3
2011,20457,SJS,1,1,0,0,0,2
2011,20458,CHI,0,1,2,0,0,3
2011,20458,COL,1,0,3,0,0,4
2011,20459,CBJ,0,1,1,0,0,2
2011,20459,VAN,1,1,0,1,0,3
2011,20460,ANA,0,1,1,0,0,2
2011,20460,NYI,3,0,0,0,0,3
2011,20461,NYR,1,1,1,0,1,4
2011,20461,PHX,2,1,0,0,0,3
2011,20462,ATL,0,2,0,0,0,2
2011,20462,CAR,0,0,2,0,1,3
2011,20463,BOS,1,1,1,0,0,3
2011,20463,MTL,3,1,0,0,0,4
2011,20464,LAK,1,3,0,0,0,4
2011,20464,STL,1,3,2,0,0,6
2011,20465,MIN,1,0,0,0,0,1
2011,20465,OTT,0,2,1,0,0,3
2011,20466,DAL,1,1,1,0,0,3
2011,20466,SJS,1,2,0,1,0,4
2011,20467,CGY,1,3,1,0,0,5
2011,20467,TOR,1,0,1,0,0,2
2011,20468,CBJ,2,0,1,0,0,3
2011,20468,EDM,3,3,0,0,0,6
2011,20469,NSH,1,1,1,0,0,3
2011,20469,NJD,0,0,1,0,0,1
2011,20470,BUF,0,1,1,0,0,2
2011,20470,FLA,4,1,1,0,0,6
2011,20471,CHI,2,1,1,0,0,4
2011,20471,DET,1,0,0,0,0,1
2011,20472,COL,1,2,2,1,0,6
2011,20472,OTT,2,1,2,0,0,5
2011,20473,NYR,0,0,1,0,0,1
2011,20473,PHI,0,1,3,0,0,4
2011,20474,BOS,3,0,0,0,0,3
2011,20474,WSH,0,1,1,0,0,2
2011,20475,NYI,0,2,1,0,0,3
2011,20475,PHX,1,0,2,0,1,4
2011,20476,ANA,1,0,1,0,0,2
2011,20476,CAR,2,1,1,0,0,4
2011,20477,ATL,3,1,3,0,0,7
2011,20477,NJD,0,1,0,0,0,1
2011,20478,CBJ,1,0,0,0,0,1
2011,20478,DAL,1,0,1,0,0,2
2011,20479,BUF,0,1,0,0,0,1
2011,20479,TBL,0,2,1,0,0,3
2011,20480,SJS,2,1,1,0,0,4
2011,20480,STL,0,1,0,0,0,1
2011,20481,LAK,4,2,0,0,0,6
2011,20481,NSH,1,0,0,0,0,1
2011,20482,CGY,0,0,1,0,0,1
2011,20482,MIN,0,2,1,0,0,3
2011,20483,TOR,0,0,1,0,0,1
2011,20483,VAN,1,1,2,0,0,4
2011,20484,OTT,2,0,0,0,0,2
2011,20484,WSH,0,3,0,0,0,3
2011,20485,DAL,2,0,1,1,0,4
2011,20485,DET,2,1,0,0,0,3
2011,20486,CHI,1,2,0,0,0,3
2011,20486,LAK,0,1,1,0,0,2
2011,20487,COL,1,2,0,0,0,3
2011,20487,MTL,1,1,0,0,0,2
2011,20488,ANA,1,2,0,0,0,3
2011,20488,BOS,0,0,0,0,0,0
2011,20489,ATL,2,1,3,0,0,6
2011,20489,TOR,0,1,2,0,0,3
2011,20490,FLA,2,2,1,0,0,5
2011,20490,PHI,0,0,0,0,0,0
2011,20491,PHX,0,0,1,0,0,1
2011,20491,PIT,2,3,1,0,0,6
2011,20492,CAR,1,0,0,0,0,1
2011,20492,TBL,2,3,0,0,0,5
2011,20493,STL,0,1,0,0,0,1
2011,20493,VAN,0,2,1,0,0,3
2011,20494,CGY,0,1,0,0,0,1
2011,20494,MIN,1,0,3,0,0,4
2011,20495,ANA,0,0,2,0,0,2
2011,20495,BUF,3,1,1,0,0,5
2011,20496,NJD,0,1,0,0,0,1
2011,20496,WSH,1,3,1,0,0,5
2011,20497,ATL,1,0,1,0,0,2
2011,20497,STL,1,1,2,0,0,4
2011,20498,CGY,0,1,0,0,0,1
2011,20498,CBJ,1,1,1,0,0,3
2011,20499,DAL,2,2,1,0,0,5
2011,20499,MTL,0,1,1,0,0,2
2011,20500,COL,0,0,0,0,0,0
2011,20500,LAK,1,1,3,0,0,5
2011,20501,EDM,0,0,1,0,0,1
2011,20501,SJS,0,2,0,0,0,2
2011,20502,NYI,0,1,0,1,0,2
2011,20502,TBL,1,0,0,0,0,1
2011,20503,FLA,1,0,1,0,0,2
2011,20503,PIT,3,1,1,0,0,5
2011,20504,DET,1,1,2,1,0,5
2011,20504,VAN,0,3,1,0,0,4
2011,20505,CHI,1,1,2,0,0,4
2011,20505,NSH,0,0,1,0,0,1
2011,20506,ATL,0,1,0,0,0,1
2011,20506,BOS,1,2,1,0,0,4
2011,20507,BUF,0,3,0,0,0,3
2011,20507,FLA,3,0,1,0,0,4
2011,20508,NJD,0,1,0,0,0,1
2011,20508,NYI,3,1,1,0,0,5
2011,20509,NYR,2,0,1,0,0,3
2011,20509,TBL,2,1,0,0,1,4
2011,20510,PIT,1,0,1,0,1,3
2011,20510,WSH,0,1,1,0,0,2
2011,20511,CAR,0,2,0,0,0,2
2011,20511,MTL,0,3,0,0,0,3
2011,20512,CBJ,0,1,2,0,0,3
2011,20512,VAN,3,3,1,0,0,7
2011,20513,DET,1,2,0,0,0,3
2011,20513,STL,3,1,0,0,0,4
2011,20514,NSH,0,1,0,0,0,1
2011,20514,OTT,1,1,0,0,0,2
2011,20515,CGY,1,0,1,0,1,3
2011,20515,DAL,1,0,1,0,0,2
2011,20516,COL,1,0,0,0,0,1
2011,20516,MIN,2,1,0,0,0,3
2011,20517,EDM,0,1,1,0,0,2
2011,20517,LAK,0,1,1,0,1,3
2011,20518,PHX,0,1,0,0,0,1
2011,20518,SJS,0,2,2,0,0,4
2011,20519,OTT,2,1,0,0,0,3
2011,20519,PIT,0,0,1,0,0,1
2011,20520,NJD,0,0,1,0,0,1
2011,20520,TOR,1,2,1,0,0,4
2011,20521,MTL,0,0,1,0,0,1
2011,20521,NYI,1,1,2,0,0,4
2011,20522,CAR,0,1,1,0,0,2
2011,20522,WSH,1,2,0,0,0,3
2011,20523,ATL,0,1,1,0,0,2
2011,20523,TBL,1,1,0,1,0,3
2011,20524,CHI,1,0,3,0,0,4
2011,20524,CBJ,0,0,1,0,0,1
2011,20525,NSH,0,0,0,0,0,0
2011,20525,STL,0,1,1,0,0,2
2011,20526,DET,2,2,0,0,0,4
2011,20526,MIN,0,0,1,0,0,1
2011,20527,DAL,0,0,0,0,0,0
2011,20527,PHX,0,1,0,0,0,1
2011,20528,EDM,0,2,0,0,0,2
2011,20528,VAN,0,1,2,0,0,3
2011,20529,ANA,0,1,0,0,0,1
2011,20529,LAK,0,4,0,0,0,4
2011,20530,NYI,2,0,0,0,0,2
2011,20530,NYR,2,2,3,0,0,7
2011,20531,CBJ,0,1,2,0,1,4
2011,20531,MIN,1,1,1,0,0,3
2011,20532,BOS,0,1,1,0,1,3
2011,20532,FLA,0,2,0,0,0,2
2011,20533,COL,2,0,1,0,0,3
2011,20533,DET,2,0,1,1,0,4
2011,20534,BUF,1,0,1,0,0,2
2011,20534,CGY,0,2,3,0,0,5
2011,20535,LAK,0,0,4,0,0,4
2011,20535,SJS,0,0,0,0,0,0
2011,20536,CAR,3,0,1,0,0,4
2011,20536,TOR,2,1,0,0,0,3
2011,20537,ATL,2,0,1,0,0,3
2011,20537,PIT,2,1,3,0,0,6
2011,20538,MTL,0,0,0,0,0,0
2011,20538,WSH,2,0,1,0,0,3
2011,20539,BOS,1,1,2,0,0,4
2011,20539,TBL,1,1,1,0,0,3
2011,20540,CHI,1,0,0,0,0,1
2011,20540,STL,0,1,2,0,0,3
2011,20541,DAL,0,1,3,0,0,4
2011,20541,NSH,0,1,1,0,0,2
2011,20542,BUF,1,1,2,0,0,4
2011,20542,EDM,1,0,1,0,0,2
2011,20543,ANA,3,0,0,0,0,3
2011,20543,PHX,0,1,0,0,0,1
2011,20544,PHI,0,1,1,0,0,2
2011,20544,VAN,1,3,2,0,0,6
2011,20545,NJD,1,0,0,0,0,1
2011,20545,NYR,1,1,1,0,0,3
2011,20546,NYI,0,1,0,0,1,2
2011,20546,PIT,0,1,0,0,0,1
2011,20547,CAR,2,1,1,0,0,4
2011,20547,OTT,0,0,0,0,0,0
2011,20548,MIN,1,1,3,0,0,5
2011,20548,SJS,1,2,0,0,0,3
2011,20549,DAL,0,3,0,0,0,3
2011,20549,DET,1,2,4,0,0,7
2011,20550,LAK,3,0,0,0,0,3
2011,20550,PHX,4,2,0,0,0,6
2011,20551,CBJ,1,1,1,0,0,3
2011,20551,TOR,2,0,0,0,0,2
2011,20552,ATL,1,1,0,0,1,3
2011,20552,BOS,1,1,0,0,0,2
2011,20553,MTL,1,0,0,0,0,1
2011,20553,TBL,0,2,2,0,0,4
2011,20554,CHI,1,2,0,0,0,3
2011,20554,SJS,1,2,2,0,0,5
2011,20555,COL,3,0,0,0,1,4
2011,20555,EDM,0,1,2,0,0,3
2011,20556,LAK,2,2,0,0,0,4
2011,20556,PHI,2,4,1,0,0,7
2011,20557,ATL,0,0,1,0,0,1
2011,20557,NJD,1,1,1,0,0,3
2011,20558,FLA,0,2,0,0,0,2
2011,20558,MTL,0,2,0,1,0,3
2011,20559,MIN,0,0,1,0,0,1
2011,20559,NSH,1,1,2,0,0,4
2011,20560,DET,1,1,1,0,0,3
2011,20560,NYI,2,1,0,1,0,4
2011,20561,CBJ,1,2,0,1,0,4
2011,20561,OTT,0,1,2,0,0,3
2011,20562,PHX,0,0,3,0,0,3
2011,20562,STL,1,2,1,0,0,4
2011,20563,ANA,1,2,2,0,0,5
2011,20563,PHI,0,1,1,0,0,2
2011,20564,DAL,0,0,1,0,0,1
2011,20564,VAN,2,2,0,0,0,4
2011,20565,CGY,0,3,0,0,0,3
2011,20565,COL,0,0,2,0,0,2
2011,20566,PIT,0,1,0,0,0,1
2011,20566,WSH,0,2,1,0,0,3
2011,20567,BOS,4,0,2,0,0,6
2011,20567,BUF,3,2,1,0,1,7
2011,20568,OTT,0,1,0,0,0,1
2011,20568,TOR,3,2,0,0,0,5
2011,20569,CAR,4,1,1,0,0,6
2011,20569,NJD,1,1,1,0,0,3
2011,20570,NYR,0,0,1,0,0,1
2011,20570,TBL,1,0,0,1,0,2
2011,20571,LAK,0,0,0,0,0,0
2011,20571,SJS,0,1,0,0,0,1
2011,20572,CGY,1,1,0,0,0,2
2011,20572,EDM,0,1,0,0,0,1
2011,20573,ATL,1,2,0,1,0,4
2011,20573,MTL,1,1,1,0,0,3
2011,20574,FLA,0,1,2,0,0,3
2011,20574,NYR,0,0,0,0,0,0
2011,20575,DET,0,0,2,0,0,2
2011,20575,PHI,0,3,0,0,0,3
2011,20576,DAL,1,0,3,0,0,4
2011,20576,STL,2,0,0,0,0,2
2011,20577,CBJ,1,0,0,0,0,1
2011,20577,NSH,0,3,1,0,0,4
2011,20578,MIN,1,2,2,1,0,6
2011,20578,PHX,1,0,4,0,0,5
2011,20579,COL,0,0,1,0,0,1
2011,20579,VAN,1,0,1,0,0,2
2011,20580,ANA,1,1,0,0,0,2
2011,20580,CHI,1,0,0,0,0,1
2011,20581,BOS,0,2,0,0,0,2
2011,20581,TOR,1,0,0,0,0,1
2011,20582,CAR,1,0,2,0,0,3
2011,20582,FLA,1,1,1,1,0,4
2011,20583,CGY,1,1,0,0,0,2
2011,20583,NYI,3,1,1,0,0,5
2011,20584,CHI,1,1,2,0,0,4
2011,20584,LAK,1,1,1,0,0,3
2011,20585,SJS,0,3,0,0,0,3
2011,20585,VAN,1,2,1,0,0,4
2011,20586,MIN,1,0,1,0,0,2
2011,20586,NJD,0,1,0,0,0,1
2011,20587,TBL,0,0,0,1,0,1
2011,20587,WSH,0,0,0,0,0,0
2011,20588,BUF,1,0,2,0,0,3
2011,20588,COL,2,0,1,1,0,4
2011,20589,DET,1,2,2,0,0,5
2011,20589,EDM,1,0,2,0,0,3
2011,20590,CBJ,0,1,1,0,0,2
2011,20590,PHX,0,2,2,0,0,4
2011,20591,CAR,0,0,1,0,0,1
2011,20591,NYR,0,0,1,1,0,2
2011,20592,PIT,5,2,1,0,0,8
2011,20592,TBL,0,0,1,0,0,1
2011,20593,ATL,2,1,0,0,0,3
2011,20593,FLA,1,0,1,0,0,2
2011,20594,CHI,0,2,0,0,0,2
2011,20594,DAL,2,0,2,0,0,4
2011,20595,CGY,0,0,1,0,0,1
2011,20595,VAN,2,1,0,0,0,3
2011,20596,ANA,0,0,1,0,0,1
2011,20596,NSH,1,1,2,0,0,4
2011,20597,BOS,0,1,0,0,0,1
2011,20597,MIN,0,1,2,0,0,3
2011,20598,STL,2,0,3,0,0,5
2011,20598,TOR,1,3,1,0,1,6
2011,20599,NJD,1,1,0,0,0,2
2011,20599,PHI,0,2,2,0,0,4
2011,20600,MTL,0,1,0,0,1,2
2011,20600,PIT,1,0,0,0,0,1
2011,20601,COL,0,0,0,0,0,0
2011,20601,PHX,1,0,1,0,0,2
2011,20602,EDM,2,0,0,0,0,2
2011,20602,NYI,0,1,0,0,0,1
2011,20603,LAK,0,2,0,0,0,2
2011,20603,NSH,0,3,2,0,0,5
2011,20604,BUF,2,1,0,0,0,3
2011,20604,SJS,0,0,0,0,0,0
2011,20605,ATL,1,0,2,0,0,3
2011,20605,TOR,2,6,1,0,0,9
2011,20606,CAR,0,2,3,0,0,5
2011,20606,FLA,2,0,1,0,0,3
2011,20607,CHI,0,1,1,0,1,3
2011,20607,OTT,0,1,1,0,0,2
2011,20608,DAL,1,1,0,0,0,2
2011,20608,NYR,0,1,1,0,1,3
2011,20609,CGY,2,2,0,0,0,4
2011,20609,DET,1,2,1,0,1,5
2011,20610,EDM,0,1,0,0,0,1
2011,20610,VAN,0,3,3,0,0,6
2011,20611,ANA,1,2,3,0,0,6
2011,20611,CBJ,0,0,0,0,0,0
2011,20612,NJD,0,1,0,0,0,1
2011,20612,PHI,2,0,0,0,0,2
2011,20613,COL,2,0,1,0,0,3
2011,20613,NYI,2,1,0,1,0,4
2011,20614,BOS,0,2,0,0,0,2
2011,20614,MTL,0,0,2,1,0,3
2011,20615,OTT,0,1,0,0,0,1
2011,20615,TBL,0,0,2,0,0,2
2011,20616,MIN,2,0,2,0,0,4
2011,20616,PIT,0,0,0,0,0,0
2011,20617,FLA,1,0,1,0,0,2
2011,20617,WSH,0,1,2,0,0,3
2011,20618,NYR,0,2,0,0,0,2
2011,20618,STL,0,1,0,0,0,1
2011,20619,BUF,0,1,0,1,0,2
2011,20619,PHX,0,1,0,0,0,1
2011,20620,NSH,1,0,1,0,0,2
2011,20620,SJS,0,1,0,0,0,1
2011,20621,DET,0,0,1,0,1,2
2011,20621,VAN,0,1,0,0,0,1
2011,20622,CBJ,0,1,3,0,0,4
2011,20622,LAK,3,1,2,0,0,6
2011,20623,ATL,1,1,1,0,0,3
2011,20623,CAR,1,2,0,1,0,4
2011,20624,NJD,1,0,5,0,0,6
2011,20624,TBL,2,0,1,0,0,3
2011,20625,DAL,2,0,2,0,0,4
2011,20625,MIN,0,0,0,0,0,0
2011,20626,CHI,1,4,0,0,0,5
2011,20626,NYI,0,0,0,0,0,0
2011,20627,ANA,0,1,0,0,0,1
2011,20627,SJS,0,0,0,0,0,0
2011,20628,BOS,0,0,4,0,0,4
2011,20628,PIT,0,2,0,0,0,2
2011,20629,PHX,0,2,2,0,0,4
2011,20629,STL,1,0,2,0,0,3
2011,20630,COL,4,1,0,0,0,5
2011,20630,DET,2,1,1,0,0,4
2011,20631,LAK,1,1,0,0,0,2
2011,20631,TOR,0,2,1,0,0,3
2011,20632,BOS,2,3,1,0,0,6
2011,20632,OTT,0,0,0,0,0,0
2011,20633,BUF,2,0,0,0,0,2
2011,20633,PHI,1,1,3,0,0,5
2011,20634,NYI,0,1,2,0,0,3
2011,20634,VAN,1,1,1,0,1,4
2011,20635,MTL,0,1,1,0,0,2
2011,20635,NYR,1,0,0,0,0,1
2011,20636,CGY,2,1,2,0,0,5
2011,20636,CAR,2,3,0,0,1,6
2011,20637,CBJ,2,1,0,0,0,3
2011,20637,PHX,0,2,2,0,0,4
2011,20638,FLA,2,1,0,1,0,4
2011,20638,WSH,0,2,1,0,0,3
2011,20639,MIN,1,0,0,0,0,1
2011,20639,NSH,1,1,3,0,0,5
2011,20640,DAL,1,1,1,0,0,3
2011,20640,EDM,0,0,2,0,0,2
2011,20641,SJS,1,0,1,0,0,2
2011,20641,TOR,0,0,4,0,0,4
2011,20642,MTL,1,1,0,0,0,2
2011,20642,PIT,1,2,2,0,0,5
2011,20643,TBL,2,1,0,0,0,3
2011,20643,WSH,0,0,0,0,0,0
2011,20644,CHI,2,1,1,0,0,4
2011,20644,COL,0,0,0,0,0,0
2011,20645,ANA,3,0,4,0,0,7
2011,20645,STL,0,2,2,0,0,4
2011,20646,BOS,1,1,5,0,0,7
2011,20646,PHI,1,2,2,0,0,5
2011,20647,BUF,1,1,1,0,0,3
2011,20647,CAR,0,1,1,0,0,2
2011,20648,NYI,1,1,2,0,0,4
2011,20648,OTT,2,4,0,0,0,6
2011,20649,NYR,0,1,0,0,0,1
2011,20649,VAN,0,0,0,0,0,0
2011,20650,FLA,1,0,2,0,0,3
2011,20650,NSH,1,0,1,0,0,2
2011,20651,PHX,1,0,4,0,0,5
2011,20651,TOR,0,0,1,0,0,1
2011,20652,LAK,0,1,0,0,0,1
2011,20652,STL,1,2,0,0,0,3
2011,20653,EDM,1,2,2,0,0,5
2011,20653,SJS,0,0,2,0,0,2
2011,20654,VAN,1,2,1,0,0,4
2011,20654,WSH,1,0,1,0,0,2
2011,20655,CBJ,2,0,0,0,1,3
2011,20655,DET,0,2,0,0,0,2
2011,20656,CGY,0,3,0,0,0,3
2011,20656,OTT,0,0,2,0,0,2
2011,20657,ATL,0,2,0,0,0,2
2011,20657,PHI,0,2,3,0,0,5
2011,20658,NJD,4,0,1,0,0,5
2011,20658,TBL,1,1,0,0,0,2
2011,20659,COL,2,1,1,0,0,4
2011,20659,MIN,0,0,1,0,0,1
2011,20660,BOS,0,2,0,0,0,2
2011,20660,PIT,1,1,1,0,0,3
2011,20661,CGY,0,0,1,0,1,2
2011,20661,TOR,0,0,1,0,0,1
2011,20662,MTL,3,0,0,0,0,3
2011,20662,NYR,1,0,1,0,0,2
2011,20663,BUF,0,1,2,0,0,3
2011,20663,NYI,0,4,1,0,0,5
2011,20664,CAR,2,3,1,0,0,6
2011,20664,TBL,2,1,1,0,0,4
2011,20665,FLA,1,1,0,1,0,3
2011,20665,NJD,1,0,1,0,0,2
2011,20666,CBJ,2,1,2,0,0,5
2011,20666,DET,2,2,1,1,0,6
2011,20667,CHI,1,1,0,0,0,2
2011,20667,NSH,0,0,2,0,1,3
2011,20668,ATL,0,1,0,0,0,1
2011,20668,DAL,1,2,3,0,0,6
2011,20669,ANA,1,0,1,0,0,2
2011,20669,PHX,1,3,2,0,0,6
2011,20670,EDM,2,0,0,0,0,2
2011,20670,LAK,2,1,2,0,0,5
2011,20671,SJS,1,1,2,0,0,4
2011,20671,STL,1,1,0,0,0,2
2011,20672,OTT,1,0,0,0,0,1
2011,20672,WSH,0,0,3,0,0,3
2011,20673,MIN,0,2,2,0,0,4
2011,20673,VAN,0,0,0,0,0,0
2011,20674,NYR,0,0,2,0,0,2
2011,20674,PHI,2,1,0,0,0,3
2011,20675,CHI,1,1,4,0,0,6
2011,20675,NSH,2,0,1,0,0,3
2011,20676,ANA,2,1,0,0,0,3
2011,20676,EDM,0,2,0,0,0,2
2011,20677,BOS,3,2,2,0,0,7
2011,20677,CAR,0,0,0,0,0,0
2011,20678,NJD,2,3,0,0,0,5
2011,20678,NYI,0,2,0,0,0,2
2011,20679,PHX,1,0,1,0,0,2
2011,20679,SJS,1,2,1,0,0,4
2011,20680,CGY,0,2,2,0,0,4
2011,20680,MTL,2,2,0,1,0,5
2011,20681,ATL,0,0,2,0,1,3
2011,20681,FLA,0,0,2,0,0,2
2011,20682,DAL,0,2,0,0,0,2
2011,20682,LAK,1,0,0,0,0,1
2011,20683,BUF,0,1,0,1,0,2
2011,20683,MTL,1,0,0,0,0,1
2011,20684,PHI,1,1,0,1,0,3
2011,20684,WSH,0,0,2,0,0,2
2011,20685,DET,0,1,0,0,0,1
2011,20685,PIT,2,1,1,0,0,4
2011,20686,BOS,1,0,2,0,0,3
2011,20686,CAR,1,0,1,0,0,2
2011,20687,ANA,1,0,0,0,1,2
2011,20687,OTT,0,1,0,0,0,1
2011,20688,CBJ,1,1,0,0,0,2
2011,20688,TBL,1,1,0,0,1,3
2011,20689,LAK,0,1,0,0,0,1
2011,20689,STL,1,0,1,0,0,2
2011,20690,COL,1,2,0,1,0,4
2011,20690,VAN,1,2,0,0,0,3
2011,20691,EDM,0,0,1,0,0,1
2011,20691,MIN,2,0,2,0,0,4
2011,20692,NSH,2,2,1,0,0,5
2011,20692,PHX,2,0,0,0,0,2
2011,20693,NYR,4,2,1,0,0,7
2011,20693,TOR,0,0,0,0,0,0
2011,20694,CBJ,1,0,1,1,0,3
2011,20694,FLA,2,0,0,0,0,2
2011,20695,CGY,0,0,0,0,0,0
2011,20695,MIN,2,1,3,0,0,6
2011,20696,BOS,1,1,0,0,0,2
2011,20696,BUF,0,2,2,0,0,4
2011,20697,ANA,1,1,0,0,0,2
2011,20697,TOR,1,2,2,0,0,5
2011,20698,NJD,2,0,0,0,0,2
2011,20698,PIT,0,0,0,0,0,0
2011,20699,NYI,0,1,0,0,0,1
2011,20699,WSH,1,1,0,0,0,2
2011,20700,OTT,0,2,0,0,0,2
2011,20700,PHI,2,1,3,0,0,6
2011,20701,CAR,2,1,1,0,0,4
2011,20701,NYR,0,0,1,0,0,1
2011,20702,ATL,1,1,0,0,0,2
2011,20702,TBL,1,0,1,0,1,3
2011,20703,DET,1,2,0,1,0,4
2011,20703,STL,0,1,2,0,0,3
2011,20704,COL,0,0,1,0,0,1
2011,20704,NSH,2,0,3,0,0,5
2011,20705,DAL,1,2,1,0,0,4
2011,20705,EDM,1,1,0,0,0,2
2011,20706,SJS,0,1,0,0,1,2
2011,20706,VAN,1,0,0,0,0,1
2011,20707,LAK,0,0,0,0,0,0
2011,20707,PHX,0,2,0,0,0,2
2011,20708,BUF,0,0,2,0,0,2
2011,20708,NYI,2,1,2,0,0,5
2011,20709,MTL,2,3,2,0,0,7
2011,20709,OTT,1,0,0,0,0,1
2011,20710,FLA,1,0,0,0,0,1
2011,20710,TBL,1,0,0,0,1,2
2011,20711,CGY,2,3,2,0,0,7
2011,20711,DAL,2,1,1,0,0,4
2011,20712,NJD,2,0,1,0,0,3
2011,20712,PHI,0,1,0,0,0,1
2011,20713,CHI,1,2,1,0,0,4
2011,20713,DET,1,0,0,0,0,1
2011,20714,BOS,2,2,2,0,0,6
2011,20714,COL,1,0,1,0,0,2
2011,20715,TOR,0,0,1,0,0,1
2011,20715,WSH,1,0,3,0,0,4
2011,20716,ANA,1,2,0,0,1,4
2011,20716,MTL,0,1,2,0,0,3
2011,20717,CAR,0,0,2,0,0,2
2011,20717,PIT,0,1,2,0,0,3
2011,20718,ATL,1,1,0,0,0,2
2011,20718,NYR,0,1,1,0,1,3
2011,20719,CBJ,1,1,3,0,0,5
2011,20719,STL,2,0,0,0,0,2
2011,20720,LAK,3,0,1,0,0,4
2011,20720,PHX,1,2,0,0,0,3
2011,20721,CGY,2,0,1,0,1,4
2011,20721,VAN,1,1,1,0,0,3
2011,20722,MIN,1,1,1,0,0,3
2011,20722,SJS,1,2,1,0,0,4
2011,20723,FLA,0,1,1,0,0,2
2011,20723,NJD,2,2,1,0,0,5
2011,20724,BUF,1,1,3,0,0,5
2011,20724,NYI,0,2,1,0,0,3
2011,20725,CHI,0,0,1,0,0,1
2011,20725,PHI,0,1,3,0,0,4
2011,20726,ATL,0,0,1,0,0,1
2011,20726,TBL,0,5,2,0,0,7
2011,20727,EDM,0,0,2,0,0,2
2011,20727,NSH,1,0,1,0,1,3
2011,20728,NYR,0,0,1,0,1,2
2011,20728,WSH,0,1,0,0,0,1
2011,20729,CAR,1,1,4,0,0,6
2011,20729,TOR,1,0,3,0,0,4
2011,20730,CGY,1,1,1,0,0,3
2011,20730,NSH,0,1,0,0,0,1
2011,20731,COL,0,2,2,0,0,4
2011,20731,STL,0,2,1,0,0,3
2011,20732,DAL,1,0,0,0,0,1
2011,20732,VAN,3,2,2,0,0,7
2011,20733,BOS,0,0,0,0,0,0
2011,20733,LAK,1,0,1,0,0,2
2011,20734,FLA,1,2,1,0,0,4
2011,20734,NYR,0,1,2,0,0,3
2011,20735,MTL,0,1,1,0,0,2
2011,20735,PHI,2,2,1,0,0,5
2011,20736,NYI,0,0,0,0,0,0
2011,20736,PIT,0,0,1,0,0,1
2011,20737,ANA,2,0,1,0,0,3
2011,20737,CBJ,1,0,1,0,0,2
2011,20738,BUF,2,0,0,1,0,3
2011,20738,OTT,1,0,1,0,0,2
2011,20739,TBL,2,0,0,0,0,2
2011,20739,TOR,0,0,0,0,0,0
2011,20740,CHI,2,0,0,0,0,2
2011,20740,MIN,1,2,1,0,0,4
2011,20741,EDM,0,1,3,0,0,4
2011,20741,PHX,1,1,1,0,0,3
2011,20742,BOS,1,1,0,0,0,2
2011,20742,FLA,0,0,1,0,0,1
2011,20743,CAR,1,2,1,0,0,4
2011,20743,NYI,0,1,1,0,0,2
2011,20744,ATL,0,1,0,0,0,1
2011,20744,WSH,0,0,0,0,0,0
2011,20745,DET,1,0,2,0,0,3
2011,20745,NJD,1,0,0,0,0,1
2011,20746,DAL,1,2,0,0,0,3
2011,20746,EDM,0,1,0,0,0,1
2011,20747,COL,1,0,1,0,0,2
2011,20747,PHX,2,1,2,0,0,5
2011,20748,CGY,1,2,1,0,0,4
2011,20748,STL,0,0,1,0,0,1
2011,20749,NSH,0,0,1,0,0,1
2011,20749,VAN,0,0,2,0,0,2
2011,20750,LAK,0,1,1,0,1,3
2011,20750,SJS,0,2,0,0,0,2
2011,20751,FLA,1,1,1,0,0,3
2011,20751,TOR,2,1,0,0,1,4
2011,20752,NJD,0,1,1,0,0,2
2011,20752,OTT,0,1,0,0,0,1
2011,20753,NYR,1,2,0,0,0,3
2011,20753,PIT,0,3,0,0,1,4
2011,20754,MTL,0,2,0,0,1,3
2011,20754,WSH,2,0,0,0,0,2
2011,20755,BOS,0,1,2,0,0,3
2011,20755,CAR,0,1,1,0,0,2
2011,20756,ATL,1,0,0,0,0,1
2011,20756,NYI,0,3,1,0,0,4
2011,20757,CHI,2,3,2,0,0,7
2011,20757,CBJ,1,2,1,0,0,4
2011,20758,PHI,0,0,0,0,0,0
2011,20758,TBL,3,0,1,0,0,4
2011,20759,COL,2,0,2,0,0,4
2011,20759,STL,1,1,1,0,0,3
2011,20760,CGY,0,0,2,0,1,3
2011,20760,NSH,1,0,1,0,0,2
2011,20761,LAK,0,0,0,0,0,0
2011,20761,MIN,0,0,0,0,1,1
2011,20762,DAL,0,1,0,0,0,1
2011,20762,VAN,0,3,1,0,0,4
2011,20763,PHX,2,1,0,0,0,3
2011,20763,SJS,0,1,4,0,0,5
2011,20764,DET,2,2,3,0,0,7
2011,20764,OTT,3,1,1,0,0,5
2011,20765,NYI,0,0,0,0,0,0
2011,20765,PIT,2,0,1,0,0,3
2011,20766,FLA,1,0,1,0,0,2
2011,20766,MTL,0,1,2,0,0,3
2011,20767,PHX,0,0,0,0,0,0
2011,20767,VAN,1,2,3,0,0,6
2011,20768,EDM,0,1,0,0,0,1
2011,20768,LAK,0,2,1,0,0,3
2011,20769,ANA,0,2,1,0,0,3
2011,20769,SJS,3,1,0,0,0,4
2011,20770,BOS,4,0,2,0,0,6
2011,20770,DAL,0,1,2,0,0,3
2011,20771,CAR,0,0,0,0,0,0
2011,20771,TOR,0,2,1,0,0,3
2011,20772,NJD,1,2,0,0,0,3
2011,20772,NYR,0,1,1,0,0,2
2011,20773,NSH,1,0,1,0,0,2
2011,20773,PHI,1,0,2,0,0,3
2011,20774,ATL,0,2,0,0,0,2
2011,20774,CGY,1,1,2,0,0,4
2011,20775,COL,0,1,2,0,0,3
2011,20775,MIN,2,1,1,0,0,4
2011,20776,FLA,2,0,1,1,0,4
2011,20776,NJD,2,1,0,0,0,3
2011,20777,BUF,2,0,0,0,0,2
2011,20777,PIT,0,3,0,0,0,3
2011,20778,CBJ,1,1,1,0,0,3
2011,20778,DET,0,0,0,0,0,0
2011,20779,TBL,1,1,0,0,0,2
2011,20779,WSH,1,2,2,0,0,5
2011,20780,EDM,1,2,0,0,0,3
2011,20780,STL,2,2,1,0,0,5
2011,20781,CHI,0,2,1,0,0,3
2011,20781,VAN,1,1,2,0,0,4
2011,20782,BOS,0,0,0,0,0,0
2011,20782,SJS,1,0,1,0,0,2
2011,20783,MTL,0,1,1,0,0,2
2011,20783,NYR,0,0,0,0,0,0
2011,20784,ANA,1,0,2,0,0,3
2011,20784,COL,0,0,0,0,0,0
2011,20785,BUF,2,3,1,0,0,6
2011,20785,TOR,0,1,1,0,0,2
2011,20786,NYI,3,0,2,0,0,5
2011,20786,OTT,3,0,0,0,0,3
2011,20787,DAL,0,1,0,0,0,1
2011,20787,PHI,1,1,1,0,0,3
2011,20788,ATL,1,0,2,0,0,3
2011,20788,CAR,0,1,2,1,0,4
2011,20789,CBJ,1,1,2,0,0,4
2011,20789,EDM,2,0,1,0,0,3
2011,20790,DET,0,0,0,0,0,0
2011,20790,NSH,1,1,1,0,0,3
2011,20791,MIN,0,0,0,0,0,0
2011,20791,PHX,0,0,1,0,0,1
2011,20792,CGY,1,1,1,0,0,3
2011,20792,LAK,2,1,0,0,1,4
2011,20793,PIT,0,0,0,0,0,0
2011,20793,WSH,1,1,1,0,0,3
2011,20794,MTL,0,1,0,0,0,1
2011,20794,NJD,2,1,1,0,0,4
2011,20795,STL,0,3,0,0,0,3
2011,20795,TBL,1,2,0,1,0,4
2011,20796,ATL,2,1,1,0,0,4
2011,20796,TOR,0,3,2,0,0,5
2011,20797,DET,0,1,2,0,0,3
2011,20797,NYR,0,0,2,0,0,2
2011,20798,EDM,1,1,2,0,0,4
2011,20798,NSH,0,0,0,0,0,0
2011,20799,CGY,1,0,2,0,0,3
2011,20799,CHI,0,1,0,0,0,1
2011,20800,COL,0,0,0,0,0,0
2011,20800,PHX,1,1,1,0,0,3
2011,20801,OTT,0,2,0,0,0,2
2011,20801,VAN,2,1,1,0,0,4
2011,20802,CAR,0,1,1,0,0,2
2011,20802,NJD,0,1,1,1,0,3
2011,20803,NYI,1,1,1,0,0,3
2011,20803,TOR,2,0,3,0,0,5
2011,20804,CBJ,1,2,1,0,0,4
2011,20804,PIT,0,0,1,0,0,1
2011,20805,SJS,0,0,2,0,0,2
2011,20805,WSH,0,0,0,0,0,0
2011,20806,BUF,1,1,5,0,0,7
2011,20806,TBL,1,2,1,0,0,4
2011,20807,FLA,1,0,0,0,0,1
2011,20807,STL,0,1,1,0,0,2
2011,20808,BOS,2,4,2,0,0,8
2011,20808,MTL,0,4,2,0,0,6
2011,20809,DET,0,1,0,0,0,1
2011,20809,NSH,2,2,0,0,0,4
2011,20810,CBJ,2,0,0,0,0,2
2011,20810,SJS,0,2,1,0,0,3
2011,20811,COL,1,0,1,0,0,2
2011,20811,MIN,2,1,0,0,0,3
2011,20812,DAL,1,1,0,0,0,2
2011,20812,PHX,1,0,1,1,0,3
2011,20813,CGY,1,2,2,0,0,5
2011,20813,OTT,2,0,0,0,0,2
2011,20814,CHI,1,1,2,0,0,4
2011,20814,EDM,0,0,1,0,0,1
2011,20815,ANA,1,2,1,0,0,4
2011,20815,VAN,0,1,2,0,0,3
2011,20816,NJD,0,0,1,1,0,2
2011,20816,TOR,0,1,0,0,0,1
2011,20817,CAR,0,0,1,0,0,1
2011,20817,PHI,0,0,2,0,0,2
2011,20818,LAK,1,0,0,0,0,1
2011,20818,PIT,1,0,0,1,0,2
2011,20819,MTL,1,2,0,0,0,3
2011,20819,NYI,1,1,1,0,1,4
2011,20820,BUF,0,1,1,1,0,3
2011,20820,FLA,0,1,1,0,0,2
2011,20821,BOS,1,0,0,0,0,1
2011,20821,DET,2,3,1,0,0,6
2011,20822,NJD,0,0,2,0,0,2
2011,20822,SJS,0,0,1,0,0,1
2011,20823,NYI,4,4,1,0,0,9
2011,20823,PIT,0,2,1,0,0,3
2011,20824,COL,1,0,0,0,0,1
2011,20824,CBJ,0,2,1,0,0,3
2011,20825,ATL,1,0,2,0,0,3
2011,20825,NYR,0,1,1,0,0,2
2011,20826,MIN,1,1,2,0,1,5
2011,20826,STL,2,0,2,0,0,4
2011,20827,CHI,3,0,0,0,0,3
2011,20827,DAL,0,2,1,0,1,4
2011,20828,ANA,1,2,1,1,0,5
2011,20828,CGY,0,2,2,0,0,4
2011,20829,LAK,0,1,3,0,0,4
2011,20829,WSH,1,0,0,0,0,1
2011,20830,EDM,1,1,1,0,0,3
2011,20830,OTT,2,0,3,0,0,5
2011,20831,MTL,0,2,1,0,0,3
2011,20831,TOR,0,0,0,0,0,0
2011,20832,CAR,0,1,2,0,0,3
2011,20832,TBL,0,2,1,1,0,4
2011,20833,COL,1,1,1,0,0,3
2011,20833,NSH,1,1,3,0,0,5
2011,20834,CHI,0,1,1,0,0,2
2011,20834,PHX,1,1,0,0,1,3
2011,20835,MIN,1,2,0,0,0,3
2011,20835,STL,0,1,0,0,0,1
2011,20836,CGY,0,2,0,0,0,2
2011,20836,VAN,1,2,1,0,0,4
2011,20837,BUF,3,1,2,0,0,6
2011,20837,NYI,2,1,3,1,0,7
2011,20838,NYR,2,3,0,0,0,5
2011,20838,PIT,2,0,1,0,0,3
2011,20839,CBJ,1,1,0,0,0,2
2011,20839,DAL,1,0,0,0,0,1
2011,20840,ATL,0,1,1,0,0,2
2011,20840,CAR,1,1,1,0,0,3
2011,20841,FLA,0,1,2,0,0,3
2011,20841,SJS,1,0,1,0,0,2
2011,20842,BOS,2,0,0,0,0,2
2011,20842,DET,1,2,1,0,0,4
2011,20843,LAK,0,1,0,0,0,1
2011,20843,PHI,0,0,0,0,0,0
2011,20844,ANA,1,2,1,0,0,4
2011,20844,EDM,0,0,0,0,0,0
2011,20845,STL,2,1,0,0,0,3
2011,20845,VAN,1,0,1,0,0,2
2011,20846,CGY,5,0,4,0,0,9
2011,20846,COL,0,1,0,0,0,1
2011,20847,PHX,0,2,1,0,0,3
2011,20847,WSH,0,1,1,0,0,2
2011,20848,BOS,1,1,1,0,0,3
2011,20848,TOR,1,1,2,0,0,4
2011,20849,BUF,0,1,1,0,1,3
2011,20849,MTL,1,1,0,0,0,2
2011,20850,NYI,0,1,2,0,1,4
2011,20850,OTT,1,1,1,0,0,3
2011,20851,PHI,1,2,0,0,1,4
2011,20851,TBL,0,3,0,0,0,3
2011,20852,NSH,1,0,0,0,0,1
2011,20852,SJS,0,1,0,1,0,2
2011,20853,MIN,1,0,0,0,0,1
2011,20853,VAN,1,2,1,0,0,4
2011,20854,DAL,0,1,0,0,0,1
2011,20854,EDM,1,2,1,0,0,4
2011,20855,BUF,0,0,1,0,0,1
2011,20855,TOR,0,1,1,0,0,2
2011,20856,CAR,0,0,2,0,0,2
2011,20856,NJD,0,1,2,0,0,3
2011,20857,CBJ,1,1,1,0,0,3
2011,20857,LAK,1,1,1,0,1,4
2011,20858,FLA,0,0,2,0,0,2
2011,20858,PHI,2,1,1,0,0,4
2011,20859,CHI,1,0,2,0,0,3
2011,20859,MIN,0,0,1,0,0,1
2011,20860,COL,0,2,0,0,0,2
2011,20860,PIT,1,1,0,1,0,3
2011,20861,CGY,1,1,2,0,0,4
2011,20861,DAL,0,2,0,0,0,2
2011,20862,ANA,3,2,1,0,0,6
2011,20862,WSH,2,2,3,0,0,7
2011,20863,BOS,3,3,0,0,0,6
2011,20863,NYI,0,2,1,0,0,3
2011,20864,LAK,1,0,2,0,0,3
2011,20864,NYR,0,1,2,0,1,4
2011,20865,DET,2,2,2,0,0,6
2011,20865,TBL,0,2,0,0,0,2
2011,20866,NSH,0,3,0,0,0,3
2011,20866,VAN,0,1,0,0,0,1
2011,20867,EDM,1,0,3,0,0,4
2011,20867,MTL,0,1,0,0,0,1
2011,20868,ATL,1,2,0,0,0,3
2011,20868,PHX,2,2,0,0,0,4
2011,20869,SJS,1,0,2,0,0,3
2011,20869,WSH,1,0,1,0,0,2
2011,20870,NJD,0,1,0,0,0,1
2011,20870,NYR,0,0,0,0,0,0
2011,20871,CAR,2,0,1,0,0,3
2011,20871,PHI,0,1,1,0,0,2
2011,20872,BUF,0,0,0,0,0,0
2011,20872,STL,0,2,1,0,0,3
2011,20873,BOS,0,1,3,0,0,4
2011,20873,OTT,0,1,1,0,0,2
2011,20874,DET,2,1,1,0,0,4
2011,20874,FLA,1,1,1,0,0,3
2011,20875,ANA,1,0,0,0,0,1
2011,20875,MIN,2,2,1,0,0,5
2011,20876,CHI,2,1,0,0,0,3
2011,20876,CBJ,1,3,0,0,0,4
2011,20877,ATL,1,1,1,0,0,3
2011,20877,EDM,0,1,4,0,0,5
2011,20878,OTT,0,0,0,0,1,1
2011,20878,TOR,0,0,0,0,0,0
2011,20879,LAK,0,0,0,0,0,0
2011,20879,NYI,1,1,1,0,0,3
2011,20880,CAR,0,0,1,0,0,1
2011,20880,NJD,3,0,1,0,0,4
2011,20881,FLA,0,1,1,0,1,3
2011,20881,TBL,1,0,1,0,0,2
2011,20882,ANA,3,0,0,0,0,3
2011,20882,STL,4,4,1,0,0,9
2011,20883,NSH,0,1,1,0,0,2
2011,20883,PHX,0,2,1,0,0,3
2011,20884,DAL,1,0,1,0,0,2
2011,20884,VAN,1,1,3,0,0,5
2011,20885,COL,0,0,0,0,0,0
2011,20885,SJS,3,0,1,0,0,4
2011,20886,BUF,0,1,0,0,0,1
2011,20886,WSH,0,1,1,0,0,2
2011,20887,NYR,1,0,1,0,0,2
2011,20887,PHI,1,2,1,0,0,4
2011,20888,CHI,1,0,1,0,1,3
2011,20888,PIT,0,1,1,0,0,2
2011,20889,DET,0,0,1,0,1,2
2011,20889,MIN,0,0,1,0,0,1
2011,20890,CGY,1,2,1,0,0,4
2011,20890,MTL,0,0,0,0,0,0
2011,20891,FLA,0,0,1,0,0,1
2011,20891,NYI,2,2,1,0,0,5
2011,20892,CHI,0,4,1,0,0,5
2011,20892,STL,2,0,1,0,0,3
2011,20893,PIT,0,0,0,0,0,0
2011,20893,WSH,0,1,0,0,0,1
2011,20894,NYI,0,1,0,0,0,1
2011,20894,TOR,1,0,1,0,0,2
2011,20895,PHI,1,0,1,0,0,2
2011,20895,PHX,0,0,2,1,0,3
2011,20896,CAR,1,0,2,0,0,3
2011,20896,NYR,1,1,1,0,1,4
2011,20897,DET,0,2,1,0,0,3
2011,20897,SJS,1,2,1,0,0,4
2011,20898,CBJ,0,0,4,0,0,4
2011,20898,NSH,0,0,0,0,0,0
2011,20899,EDM,0,1,0,0,0,1
2011,20899,MIN,0,1,3,0,0,4
2011,20900,DAL,0,0,0,0,0,0
2011,20900,NJD,0,0,1,0,0,1
2011,20901,MTL,2,1,0,0,0,3
2011,20901,VAN,0,1,1,0,0,2
2011,20902,ATL,0,1,0,0,0,1
2011,20902,BUF,1,2,1,0,0,4
2011,20903,FLA,0,1,0,0,0,1
2011,20903,OTT,1,2,2,0,0,5
2011,20904,PIT,1,0,1,0,0,2
2011,20904,SJS,0,1,1,1,0,3
2011,20905,PHX,0,1,2,0,0,3
2011,20905,TBL,5,2,1,0,0,8
2011,20906,BOS,1,0,2,0,0,3
2011,20906,CGY,0,0,1,0,0,1
2011,20907,COL,0,1,0,0,0,1
2011,20907,EDM,1,2,2,0,0,5
2011,20908,ANA,1,1,0,0,0,2
2011,20908,LAK,2,0,1,0,0,3
2011,20909,NYI,1,0,2,0,0,3
2011,20909,PHI,0,2,1,1,0,4
2011,20910,DAL,2,1,1,0,0,4
2011,20910,DET,0,0,1,0,0,1
2011,20911,MTL,1,2,1,0,0,4
2011,20911,TOR,3,1,1,0,0,5
2011,20912,CHI,1,0,2,0,0,3
2011,20912,NSH,0,0,0,0,0,0
2011,20913,STL,0,2,0,0,0,2
2011,20913,VAN,2,0,1,0,0,3
2011,20914,LAK,1,1,2,0,0,4
2011,20914,MIN,0,2,0,0,0,2
2011,20915,NYR,2,2,2,0,0,6
2011,20915,WSH,0,0,0,0,0,0
2011,20916,CAR,2,1,1,0,0,4
2011,20916,PIT,0,1,0,0,0,1
2011,20917,CBJ,2,2,1,0,0,5
2011,20917,PHX,2,0,1,0,0,3
2011,20918,BUF,1,1,2,0,0,4
2011,20918,OTT,0,1,1,0,0,2
2011,20919,ATL,0,1,0,0,0,1
2011,20919,FLA,1,0,0,0,1,2
2011,20920,NJD,0,0,1,0,0,1
2011,20920,TBL,0,2,0,0,0,2
2011,20921,CGY,1,2,0,0,0,3
2011,20921,SJS,1,1,1,0,1,4
2011,20922,EDM,0,0,0,0,0,0
2011,20922,STL,2,1,2,0,0,5
2011,20923,ANA,0,1,1,0,0,2
2011,20923,MIN,1,0,1,1,0,3
2011,20924,DAL,1,0,2,0,0,3
2011,20924,NSH,0,2,0,0,0,2
2011,20925,COL,0,0,3,0,0,3
2011,20925,LAK,1,2,1,0,0,4
2011,20926,BUF,2,0,0,0,0,2
2011,20926,DET,0,1,1,0,1,3
2011,20927,PIT,1,2,2,0,1,6
2011,20927,TOR,1,1,3,0,0,5
2011,20928,CAR,1,2,0,0,0,3
2011,20928,MTL,2,1,1,0,0,4
2011,20929,OTT,0,2,2,0,0,4
2011,20929,PHI,1,0,0,0,0,1
2011,20930,NYI,1,1,0,0,0,2
2011,20930,WSH,0,1,2,0,0,3
2011,20931,BOS,0,1,2,0,0,3
2011,20931,VAN,1,0,0,0,0,1
2011,20932,NYR,0,1,0,0,0,1
2011,20932,TBL,1,0,1,0,0,2
2011,20933,CBJ,0,1,1,0,0,2
2011,20933,NSH,0,0,3,0,0,3
2011,20934,ATL,0,0,2,1,0,3
2011,20934,TOR,2,0,0,0,0,2
2011,20935,FLA,0,0,1,0,0,1
2011,20935,NJD,0,2,0,0,0,2
2011,20936,CHI,2,1,0,0,1,4
2011,20936,PHX,0,3,0,0,0,3
2011,20937,CGY,0,0,1,0,0,1
2011,20937,STL,0,0,0,0,0,0
2011,20938,BOS,2,1,0,0,0,3
2011,20938,EDM,1,0,1,0,0,2
2011,20939,ANA,0,2,1,0,0,3
2011,20939,COL,1,0,1,0,0,2
2011,20940,CHI,0,3,1,0,0,4
2011,20940,MIN,0,0,2,0,0,2
2011,20941,DET,3,1,3,0,0,7
2011,20941,LAK,1,0,3,0,0,4
2011,20942,BUF,1,1,1,0,0,3
2011,20942,NYR,0,1,1,0,0,2
2011,20943,NYI,0,1,0,0,0,1
2011,20943,WSH,0,0,1,1,0,2
2011,20944,CAR,2,0,0,0,0,2
2011,20944,FLA,0,1,0,0,0,1
2011,20945,ATL,0,0,1,0,0,1
2011,20945,MTL,1,1,1,0,0,3
2011,20946,BOS,0,0,1,0,0,1
2011,20946,OTT,0,0,0,0,0,0
2011,20947,CGY,1,0,5,0,0,6
2011,20947,STL,0,0,0,0,0,0
2011,20948,EDM,1,0,0,0,1,2
2011,20948,NSH,1,0,0,0,0,1
2011,20949,DAL,1,0,2,0,0,3
2011,20949,PHX,0,0,2,0,0,2
2011,20950,CBJ,0,1,0,0,0,1
2011,20950,VAN,1,0,0,0,1,2
2011,20951,COL,0,0,1,0,0,1
2011,20951,SJS,0,0,1,0,1,2
2011,20952,PIT,1,1,0,0,0,2
2011,20952,TOR,1,0,1,1,0,3
2011,20953,NJD,0,1,1,0,0,2
2011,20953,TBL,0,1,0,0,0,1
2011,20954,MIN,0,0,1,0,0,1
2011,20954,NYI,2,2,0,0,0,4
2011,20955,CGY,1,0,3,0,0,4
2011,20955,CHI,2,2,2,0,0,6
2011,20956,ANA,0,0,1,1,0,2
2011,20956,DET,0,1,0,0,0,1
2011,20957,BOS,0,1,1,0,0,2
2011,20957,TBL,0,1,0,0,0,1
2011,20958,MIN,0,2,1,0,0,3
2011,20958,NYR,1,0,0,0,0,1
2011,20959,PHI,1,1,0,0,0,2
2011,20959,TOR,1,1,1,0,0,3
2011,20960,STL,1,1,0,0,0,2
2011,20960,WSH,0,2,1,0,0,3
2011,20961,BUF,0,2,0,0,0,2
2011,20961,CAR,0,2,0,1,0,3
2011,20962,ATL,0,0,1,0,0,1
2011,20962,OTT,1,0,2,0,0,3
2011,20963,FLA,0,0,0,0,0,0
2011,20963,MTL,2,1,1,0,0,4
2011,20964,CBJ,0,1,1,0,0,2
2011,20964,EDM,2,1,1,0,0,4
2011,20965,NSH,0,0,3,0,0,3
2011,20965,VAN,0,0,0,0,0,0
2011,20966,LAK,0,0,1,0,0,1
2011,20966,PHX,0,0,0,0,0,0
2011,20967,DET,1,0,0,0,0,1
2011,20967,SJS,1,1,1,0,0,3
2011,20968,NJD,0,1,0,1,0,2
2011,20968,PIT,0,1,0,0,0,1
2011,20969,NYR,1,2,1,0,0,4
2011,20969,OTT,0,0,1,0,0,1
2011,20970,CAR,1,0,1,0,0,2
2011,20970,CHI,2,0,3,0,0,5
2011,20971,CGY,2,2,0,0,0,4
2011,20971,CBJ,1,1,1,0,0,3
2011,20972,ANA,1,0,2,1,0,4
2011,20972,DAL,0,3,0,0,0,3
2011,20973,NYI,2,1,2,0,0,5
2011,20973,STL,0,0,2,0,0,2
2011,20974,BUF,0,3,2,0,0,5
2011,20974,PHI,2,1,0,0,0,3
2011,20975,LAK,1,0,0,0,0,1
2011,20975,VAN,1,0,2,0,0,3
2011,20976,BOS,0,1,1,0,0,2
2011,20976,PIT,0,2,0,1,0,3
2011,20977,CHI,3,2,0,0,0,5
2011,20977,TOR,0,1,2,0,0,3
2011,20978,ATL,0,1,2,1,0,4
2011,20978,FLA,1,0,2,0,0,3
2011,20979,MTL,2,1,1,0,0,4
2011,20979,TBL,0,1,1,0,0,2
2011,20980,DET,2,2,0,0,0,4
2011,20980,PHX,1,0,3,0,1,5
2011,20981,COL,0,1,0,0,0,1
2011,20981,EDM,2,2,1,0,0,5
2011,20982,DAL,1,0,2,0,0,3
2011,20982,SJS,1,1,0,0,0,2
2011,20983,NJD,0,1,1,0,1,3
2011,20983,NYI,0,1,1,0,0,2
2011,20984,NYR,2,2,3,0,0,7
2011,20984,PHI,0,0,0,0,0,0
2011,20985,FLA,1,0,1,0,0,2
2011,20985,WSH,1,1,0,1,0,3
2011,20986,BUF,1,1,0,1,0,3
2011,20986,MIN,0,2,0,0,0,2
2011,20987,CGY,1,1,1,0,0,3
2011,20987,NSH,2,0,0,0,0,2
2011,20988,ANA,0,0,0,0,0,0
2011,20988,VAN,1,1,1,0,0,3
2011,20989,TBL,1,0,0,0,0,1
2011,20989,WSH,0,0,1,0,1,2
2011,20990,CBJ,3,1,0,0,0,4
2011,20990,STL,3,1,0,0,1,5
2011,20991,DAL,0,1,2,1,0,4
2011,20991,LAK,1,1,1,0,0,3
2011,20992,NJD,0,0,1,0,0,1
2011,20992,OTT,0,1,1,0,0,2
2011,20993,NYI,0,2,1,1,0,4
2011,20993,TOR,0,2,1,0,0,3
2011,20994,EDM,0,1,0,0,0,1
2011,20994,PHI,2,1,1,0,0,4
2011,20995,BUF,1,0,0,0,0,1
2011,20995,PIT,0,2,1,0,0,3
2011,20996,BOS,0,0,1,0,0,1
2011,20996,MTL,2,2,0,0,0,4
2011,20997,CHI,0,2,0,0,0,2
2011,20997,FLA,3,0,0,0,0,3
2011,20998,COL,0,2,0,0,0,2
2011,20998,MIN,1,1,3,0,0,5
2011,20999,PHX,2,1,0,0,0,3
2011,20999,VAN,1,2,0,1,0,4
2011,21000,NSH,1,1,0,0,0,2
2011,21000,SJS,1,1,0,1,0,3
2011,21001,EDM,0,0,0,0,0,0
2011,21001,WSH,0,2,3,0,0,5
2011,21002,ATL,2,0,0,1,0,3
2011,21002,CAR,0,1,1,0,0,2
2011,21003,DET,1,0,0,0,0,1
2011,21003,LAK,0,2,0,0,0,2
2011,21004,CBJ,0,3,0,0,0,3
2011,21004,STL,0,1,2,1,0,4
2011,21005,CHI,1,1,1,0,0,3
2011,21005,TBL,2,1,0,0,1,4
2011,21006,CGY,3,0,0,0,1,4
2011,21006,DAL,1,1,1,0,0,3
2011,21007,ANA,3,0,2,0,0,5
2011,21007,NYR,1,0,1,0,0,2
2011,21008,BOS,1,1,1,0,0,3
2011,21008,BUF,0,2,1,1,0,4
2011,21009,PHI,1,2,0,0,0,3
2011,21009,TOR,0,1,1,0,0,2
2011,21010,FLA,0,0,1,0,0,1
2011,21010,OTT,0,0,2,0,0,2
2011,21011,MTL,1,0,0,0,0,1
2011,21011,STL,1,1,2,0,0,4
2011,21012,MIN,0,0,0,0,0,0
2011,21012,NSH,3,0,1,0,0,4
2011,21013,CGY,0,0,0,0,0,0
2011,21013,PHX,0,1,2,0,0,3
2011,21014,SJS,0,2,2,0,0,4
2011,21014,VAN,2,1,1,0,1,5
2011,21015,BOS,1,1,0,0,0,2
2011,21015,NYI,0,1,3,0,0,4
2011,21016,CAR,0,1,0,0,0,1
2011,21016,WSH,0,0,2,0,0,2
2011,21017,DET,0,0,1,1,0,2
2011,21017,EDM,1,0,0,0,0,1
2011,21018,CBJ,1,0,1,0,0,2
2011,21018,LAK,2,1,1,0,0,4
2011,21019,ATL,0,1,1,0,0,2
2011,21019,NJD,0,1,1,1,0,3
2011,21020,OTT,1,1,0,0,0,2
2011,21020,TBL,0,0,1,0,0,1
2011,21021,DAL,1,3,0,0,0,4
2011,21021,MIN,0,0,0,0,0,0
2011,21022,ANA,0,4,2,0,0,6
2011,21022,COL,1,1,0,0,0,2
2011,21023,MTL,1,2,0,0,0,3
2011,21023,PIT,0,0,0,0,0,0
2011,21024,BUF,1,2,0,0,0,3
2011,21024,TOR,1,1,2,0,0,4
2011,21025,NJD,1,0,1,1,0,3
2011,21025,NYI,0,2,0,0,0,2
2011,21026,ATL,0,0,4,1,0,5
2011,21026,PHI,1,2,1,0,0,4
2011,21027,CAR,0,0,2,0,0,2
2011,21027,CBJ,1,1,1,0,0,3
2011,21028,FLA,0,1,2,1,0,4
2011,21028,TBL,0,1,2,0,0,3
2011,21029,DET,2,1,2,0,0,5
2011,21029,STL,1,0,2,0,0,3
2011,21030,COL,0,2,0,0,0,2
2011,21030,NSH,2,1,1,0,0,4
2011,21031,CGY,2,1,0,0,0,3
2011,21031,VAN,1,3,0,0,0,4
2011,21032,NYR,1,1,0,0,1,3
2011,21032,SJS,1,1,0,0,0,2
2011,21033,EDM,0,0,1,0,0,1
2011,21033,PIT,1,2,2,0,0,5
2011,21034,CHI,1,1,1,0,0,3
2011,21034,WSH,2,0,1,1,0,4
2011,21035,DAL,0,1,1,0,0,2
2011,21035,LAK,1,1,1,0,0,3
2011,21036,BUF,2,3,1,0,0,6
2011,21036,OTT,2,1,1,0,0,4
2011,21037,ANA,1,1,0,0,0,2
2011,21037,PHX,2,2,1,0,0,5
2011,21038,TBL,1,3,2,0,0,6
2011,21038,TOR,0,2,0,0,0,2
2011,21039,CHI,1,5,0,0,0,6
2011,21039,SJS,2,1,0,0,0,3
2011,21040,MIN,0,1,1,0,0,2
2011,21040,VAN,3,0,1,0,0,4
2011,21041,BUF,0,0,0,0,0,0
2011,21041,CAR,1,0,0,0,0,1
2011,21042,ATL,2,0,0,0,0,2
2011,21042,NJD,1,1,2,0,0,4
2011,21043,NYI,0,2,1,0,0,3
2011,21043,NYR,2,3,1,0,0,6
2011,21044,BOS,0,1,1,0,1,3
2011,21044,CBJ,1,0,1,0,0,2
2011,21045,MTL,1,1,0,0,0,2
2011,21045,WSH,2,0,2,0,0,4
2011,21046,OTT,0,1,0,0,0,1
2011,21046,PIT,1,3,1,0,0,5
2011,21047,FLA,2,0,0,0,0,2
2011,21047,PHI,1,2,0,0,0,3
2011,21048,LAK,1,2,1,0,0,4
2011,21048,NSH,1,0,1,0,0,2
2011,21049,DAL,0,2,1,0,0,3
2011,21049,SJS,0,2,4,0,0,6
2011,21050,CGY,1,0,2,0,0,3
2011,21050,PHX,1,1,2,0,0,4
2011,21051,CAR,1,0,0,0,0,1
2011,21051,TOR,1,2,0,0,0,3
2011,21052,DET,2,0,1,0,0,3
2011,21052,WSH,1,1,0,0,0,2
2011,21053,COL,2,0,0,0,0,2
2011,21053,VAN,0,1,3,0,0,4
2011,21054,ANA,0,1,1,0,0,2
2011,21054,STL,0,1,0,0,0,1
2011,21055,ATL,1,2,0,0,1,4
2011,21055,PHI,1,1,1,0,0,3
2011,21056,CBJ,0,0,0,0,0,0
2011,21056,DET,2,0,0,0,0,2
2011,21057,MTL,0,1,1,0,1,3
2011,21057,TBL,0,1,1,0,0,2
2011,21058,NJD,0,0,1,0,0,1
2011,21058,OTT,1,0,2,0,0,3
2011,21059,FLA,0,3,1,0,0,4
2011,21059,TOR,0,0,0,0,0,0
2011,21060,BOS,1,1,1,0,0,3
2011,21060,NSH,1,1,1,1,0,4
2011,21061,CHI,0,0,0,0,0,0
2011,21061,DAL,1,2,2,0,0,5
2011,21062,CGY,3,0,2,0,0,5
2011,21062,COL,1,0,1,0,0,2
2011,21063,EDM,0,0,1,0,0,1
2011,21063,PHX,1,1,1,0,0,3
2011,21064,LAK,0,0,0,0,0,0
2011,21064,STL,1,1,2,0,0,4
2011,21065,MIN,1,1,0,0,0,2
2011,21065,SJS,1,1,1,0,0,3
2011,21066,NJD,0,0,0,0,0,0
2011,21066,WSH,1,1,1,0,0,3
2011,21067,MTL,1,1,1,0,0,3
2011,21067,NYR,5,0,1,0,0,6
2011,21068,CAR,1,0,1,1,0,3
2011,21068,NYI,1,1,0,0,0,2
2011,21069,PHX,0,0,3,0,0,3
2011,21069,VAN,0,0,1,0,0,1
2011,21070,CBJ,1,1,2,1,0,5
2011,21070,MIN,1,1,2,0,0,4
2011,21071,ATL,1,1,0,0,0,2
2011,21071,BUF,3,2,3,0,0,8
2011,21072,BOS,1,0,1,0,0,2
2011,21072,TOR,2,3,0,0,0,5
2011,21073,OTT,0,0,2,1,0,3
2011,21073,TBL,1,1,0,0,0,2
2011,21074,FLA,0,2,1,0,0,3
2011,21074,NYI,0,1,2,0,1,4
2011,21075,DET,1,0,0,0,0,1
2011,21075,NSH,0,1,2,0,0,3
2011,21076,DAL,0,1,1,0,0,2
2011,21076,PHI,1,1,0,0,1,3
2011,21077,COL,1,1,0,0,1,3
2011,21077,EDM,0,1,1,0,0,2
2011,21078,ANA,1,0,0,1,0,2
2011,21078,LAK,0,0,1,0,0,1
2011,21079,SJS,3,2,0,0,0,5
2011,21079,STL,0,1,2,0,0,3
2011,21080,NYR,1,0,4,0,0,5
2011,21080,PIT,1,0,1,0,0,2
2011,21081,BUF,0,3,0,0,0,3
2011,21081,NSH,1,0,2,1,0,4
2011,21082,CBJ,0,0,0,0,0,0
2011,21082,NJD,1,1,1,0,0,3
2011,21083,MIN,0,0,1,0,0,1
2011,21083,MTL,2,4,2,0,0,8
2011,21084,CHI,1,0,1,0,0,2
2011,21084,PHX,0,1,0,0,0,1
2011,21085,ANA,3,0,1,1,0,5
2011,21085,CGY,1,2,1,0,0,4
2011,21086,DET,0,1,3,0,0,4
2011,21086,PIT,2,2,0,0,1,5
2011,21087,CGY,0,0,1,0,0,1
2011,21087,LAK,0,0,1,0,1,2
2011,21088,BOS,1,1,2,0,0,4
2011,21088,NJD,1,0,0,0,0,1
2011,21089,FLA,0,0,0,0,0,0
2011,21089,NYR,0,0,1,0,0,1
2011,21090,PHI,0,2,2,0,0,4
2011,21090,WSH,2,1,1,0,1,5
2011,21091,CAR,2,1,1,0,0,4
2011,21091,OTT,2,0,1,0,0,3
2011,21092,BUF,0,1,1,0,0,2
2011,21092,MTL,0,0,0,0,0,0
2011,21093,NYI,1,2,2,0,0,5
2011,21093,TBL,1,0,1,0,0,2
2011,21094,EDM,0,1,0,0,0,1
2011,21094,NSH,2,1,0,0,0,3
2011,21095,MIN,0,0,0,0,0,0
2011,21095,TOR,1,1,1,0,0,3
2011,21096,COL,1,0,3,0,1,5
2011,21096,CBJ,1,1,2,0,0,4
2011,21097,PHX,0,2,0,0,0,2
2011,21097,STL,1,0,0,0,0,1
2011,21098,DET,0,0,1,0,0,1
2011,21098,VAN,0,1,1,0,0,2
2011,21099,CHI,0,1,3,0,0,4
2011,21099,FLA,0,0,0,0,0,0
2011,21100,ANA,0,1,2,1,0,4
2011,21100,DAL,0,1,2,0,0,3
2011,21101,CGY,2,1,0,0,0,3
2011,21101,SJS,4,1,1,0,0,6
2011,21102,BOS,3,0,4,0,0,7
2011,21102,MTL,0,0,0,0,0,0
2011,21103,ATL,1,1,0,0,0,2
2011,21103,NYI,0,1,0,0,0,1
2011,21104,NYR,0,0,1,0,0,1
2011,21104,OTT,0,1,0,0,1,2
2011,21105,PHI,1,0,0,0,0,1
2011,21105,PIT,0,1,0,0,1,2
2011,21106,EDM,0,0,0,0,0,0
2011,21106,STL,0,1,3,0,0,4
2011,21107,ANA,1,0,3,0,0,4
2011,21107,NSH,3,1,1,0,0,5
2011,21108,COL,1,1,1,0,0,3
2011,21108,TOR,2,1,1,0,0,4
2011,21109,CBJ,0,0,0,0,0,0
2011,21109,PHX,0,2,1,0,0,3
2011,21110,LAK,0,2,1,0,1,4
2011,21110,SJS,0,1,2,0,0,3
2011,21111,NJD,0,0,0,0,0,0
2011,21111,PIT,0,0,0,0,1,1
2011,21112,BUF,1,1,2,0,0,4
2011,21112,FLA,1,0,1,0,0,2
2011,21113,OTT,0,1,1,0,0,2
2011,21113,WSH,0,0,0,0,0,0
2011,21114,ATL,0,0,1,0,0,1
2011,21114,VAN,0,2,1,0,0,3
2011,21115,CAR,1,1,2,0,0,4
2011,21115,TBL,1,0,2,0,0,3
2011,21116,BOS,0,0,0,0,0,0
2011,21116,NYR,1,0,0,0,0,1
2011,21117,COL,0,1,0,0,0,1
2011,21117,LAK,2,0,2,0,0,4
2011,21118,BUF,2,0,0,0,0,2
2011,21118,NJD,0,0,0,0,0,0
2011,21119,MTL,0,0,0,0,0,0
2011,21119,WSH,1,0,1,0,0,2
2011,21120,NYI,1,0,0,0,0,1
2011,21120,PHI,3,0,1,0,0,4
2011,21121,CAR,2,0,0,0,0,2
2011,21121,TBL,2,1,1,0,0,4
2011,21122,DET,1,1,2,0,0,4
2011,21122,TOR,1,0,1,0,0,2
2011,21123,DAL,1,1,0,0,0,2
2011,21123,NSH,1,2,1,0,0,4
2011,21124,MIN,2,0,1,0,0,3
2011,21124,STL,2,2,2,0,0,6
2011,21125,ANA,0,0,2,0,0,2
2011,21125,CHI,1,0,0,0,0,1
2011,21126,PHX,1,0,0,0,0,1
2011,21126,SJS,1,2,1,0,0,4
2011,21127,CGY,0,1,3,0,1,5
2011,21127,EDM,1,2,1,0,0,4
2011,21128,FLA,0,1,0,0,0,1
2011,21128,PIT,0,1,0,0,1,2
2011,21129,ATL,1,2,1,0,1,5
2011,21129,OTT,1,1,2,0,0,4
2011,21130,CBJ,0,0,1,0,0,1
2011,21130,VAN,1,0,3,0,0,4
2011,21131,BOS,0,1,1,0,0,2
2011,21131,PHI,1,0,0,0,0,1
2011,21132,CHI,2,0,0,1,0,3
2011,21132,DET,1,0,1,0,0,2
2011,21133,ANA,0,3,2,0,0,5
2011,21133,COL,2,1,1,0,0,4
2011,21134,BOS,0,2,1,0,0,3
2011,21134,CHI,0,0,0,0,0,0
2011,21135,BUF,1,2,0,0,0,3
2011,21135,TOR,2,2,0,0,0,4
2011,21136,PHI,1,2,2,0,0,5
2011,21136,PIT,1,1,0,0,0,2
2011,21137,CAR,0,1,1,0,1,3
2011,21137,WSH,0,2,0,0,0,2
2011,21138,CBJ,1,1,0,0,1,3
2011,21138,FLA,0,1,1,0,0,2
2011,21139,ATL,0,0,1,0,0,1
2011,21139,MTL,2,0,1,0,0,3
2011,21140,OTT,0,0,2,0,0,2
2011,21140,TBL,0,2,3,0,0,5
2011,21141,MIN,1,0,1,0,1,3
2011,21141,STL,1,0,1,0,0,2
2011,21142,NSH,0,1,0,0,0,1
2011,21142,VAN,0,0,3,0,0,3
2011,21143,EDM,0,0,0,0,0,0
2011,21143,LAK,0,2,0,0,0,2
2011,21144,DAL,0,1,0,0,0,1
2011,21144,PHX,0,1,0,0,1,2
2011,21145,BUF,0,1,0,0,0,1
2011,21145,NYR,0,0,0,0,0,0
2011,21146,NJD,1,1,1,0,0,3
2011,21146,NYI,0,0,2,0,0,2
2011,21147,CAR,2,2,2,0,0,6
2011,21147,MTL,0,1,1,0,0,2
2011,21148,DET,2,1,0,0,0,3
2011,21148,STL,3,5,2,0,0,10
2011,21149,ANA,2,1,1,0,0,4
2011,21149,CGY,1,0,1,0,0,2
2011,21150,BOS,0,3,0,0,0,3
2011,21150,TOR,1,1,1,0,1,4
2011,21151,NYI,0,4,2,0,0,6
2011,21151,NYR,1,0,1,0,0,2
2011,21152,ATL,0,0,1,0,0,1
2011,21152,PHI,0,0,0,0,0,0
2011,21153,CBJ,0,2,1,0,0,3
2011,21153,WSH,1,2,0,1,0,4
2011,21154,PIT,0,0,1,0,0,1
2011,21154,TBL,2,0,0,0,0,2
2011,21155,FLA,0,1,0,0,0,1
2011,21155,OTT,1,3,0,0,0,4
2011,21156,EDM,0,1,1,0,0,2
2011,21156,MIN,2,2,0,0,0,4
2011,21157,COL,0,0,2,0,0,2
2011,21157,NSH,1,1,1,0,0,3
2011,21158,LAK,1,0,0,0,0,1
2011,21158,VAN,0,2,1,0,0,3
2011,21159,DAL,0,0,0,0,0,0
2011,21159,SJS,1,2,3,0,0,6
2011,21160,NJD,0,2,2,0,0,4
2011,21160,PHI,1,0,1,0,0,2
2011,21161,CHI,2,0,1,0,1,4
2011,21161,CBJ,1,1,1,0,0,3
2011,21162,CGY,0,1,2,0,0,3
2011,21162,STL,1,1,0,0,0,2
2011,21163,COL,1,1,1,0,1,4
2011,21163,PHX,0,1,2,0,0,3
2011,21164,ATL,1,1,0,0,0,2
2011,21164,BOS,1,1,1,0,0,3
2011,21165,MIN,1,0,0,0,0,1
2011,21165,TBL,0,2,1,0,0,3
2011,21166,DET,0,2,1,1,0,4
2011,21166,NSH,1,2,0,0,0,3
2011,21167,DAL,0,1,0,0,0,1
2011,21167,LAK,0,1,2,0,0,3
2011,21168,OTT,0,1,1,0,0,2
2011,21168,TOR,1,1,2,0,0,4
2011,21169,MTL,1,0,2,0,0,3
2011,21169,NJD,0,0,1,0,0,1
2011,21170,CAR,1,0,3,0,0,4
2011,21170,NYI,1,1,0,0,0,2
2011,21171,BUF,2,0,2,0,0,4
2011,21171,WSH,2,0,2,1,0,5
2011,21172,FLA,2,0,0,0,0,2
2011,21172,PIT,1,1,2,0,0,4
2011,21173,EDM,1,2,1,0,0,4
2011,21173,VAN,0,1,0,0,0,1
2011,21174,ANA,2,0,0,0,0,2
2011,21174,SJS,0,2,2,0,0,4
2011,21175,NYR,1,1,0,0,1,3
2011,21175,PHI,1,0,1,0,0,2
2011,21176,BUF,1,0,0,1,0,2
2011,21176,CAR,0,1,0,0,0,1
2011,21177,DET,2,1,1,0,0,4
2011,21177,MIN,0,1,1,0,0,2
2011,21178,CBJ,1,0,0,0,0,1
2011,21178,STL,2,2,2,0,0,6
2011,21179,CHI,0,0,0,0,0,0
2011,21179,TBL,1,0,1,0,0,2
2011,21180,CGY,0,1,1,0,0,2
2011,21180,COL,0,0,1,0,0,1
2011,21181,ANA,2,1,0,0,0,3
2011,21181,DAL,2,2,0,0,0,4
2011,21182,BOS,2,1,0,0,0,3
2011,21182,NYR,0,2,3,0,0,5
2011,21183,LAK,0,1,0,0,0,1
2011,21183,SJS,2,4,0,0,0,6
2011,21184,BUF,1,2,1,0,0,4
2011,21184,TBL,1,0,1,0,0,2
2011,21185,TOR,1,1,0,0,0,2
2011,21185,WSH,1,1,0,0,1,3
2011,21186,NJD,0,1,1,0,0,2
2011,21186,PIT,1,1,2,0,0,4
2011,21187,CHI,0,1,0,0,0,1
2011,21187,MTL,0,1,0,1,0,2
2011,21188,OTT,1,2,2,0,0,5
2011,21188,PHI,1,1,0,0,0,2
2011,21189,COL,1,0,0,0,0,1
2011,21189,STL,1,1,1,0,0,3
2011,21190,ATL,0,0,3,0,0,3
2011,21190,NSH,3,1,2,0,0,6
2011,21191,CBJ,0,0,0,0,0,0
2011,21191,DAL,1,0,2,0,0,3
2011,21192,EDM,1,0,1,0,0,2
2011,21192,VAN,0,0,0,0,0,0
2011,21193,BOS,1,2,0,0,0,3
2011,21193,NYI,0,2,0,0,0,2
2011,21194,NJD,1,2,1,0,0,4
2011,21194,TOR,0,0,2,0,0,2
2011,21195,FLA,0,0,2,0,0,2
2011,21195,WSH,2,1,2,0,0,5
2011,21196,CAR,0,2,1,0,0,3
2011,21196,DET,0,0,0,0,0,0
2011,21197,CHI,0,3,0,1,0,4
2011,21197,STL,1,1,1,0,0,3
2011,21198,CGY,0,3,3,0,0,6
2011,21198,EDM,0,0,1,0,0,1
2011,21199,ANA,2,4,0,0,0,6
2011,21199,SJS,0,1,1,0,0,2
2011,21200,LAK,1,1,0,0,1,3
2011,21200,PHX,2,0,0,0,0,2
2011,21201,ATL,0,2,1,0,0,3
2011,21201,NYR,0,0,0,0,0,0
2011,21202,MTL,0,1,1,0,0,2
2011,21202,OTT,0,0,2,1,0,3
2011,21203,COL,0,1,1,0,0,2
2011,21203,DAL,2,0,2,0,0,4
2011,21204,MIN,0,0,0,0,0,0
2011,21204,VAN,2,2,1,0,0,5
2011,21205,NYI,0,1,2,0,0,3
2011,21205,PIT,1,1,1,0,1,4
2011,21206,CHI,3,1,0,0,0,4
2011,21206,DET,0,1,1,0,0,2
2011,21207,BUF,0,2,1,1,0,4
2011,21207,PHI,1,2,0,0,0,3
2011,21208,ATL,0,0,1,0,0,1
2011,21208,CAR,2,1,3,0,0,6
2011,21209,FLA,1,0,1,0,0,2
2011,21209,TBL,2,2,0,0,0,4
2011,21210,CBJ,0,1,0,0,0,1
2011,21210,NSH,1,2,1,0,0,4
2011,21211,COL,0,1,1,0,0,2
2011,21211,DAL,1,1,1,0,0,3
2011,21212,EDM,0,1,0,0,0,1
2011,21212,MIN,1,1,1,0,0,3
2011,21213,PHX,1,2,1,0,0,4
2011,21213,SJS,0,1,2,0,0,3
2011,21214,ANA,0,1,1,0,0,2
2011,21214,LAK,1,0,0,0,0,1
2011,21215,NJD,2,0,0,0,0,2
2011,21215,NYR,1,3,1,0,0,5
2011,21216,BOS,1,1,1,0,0,3
2011,21216,OTT,1,0,0,0,0,1
2011,21217,MTL,2,1,1,0,0,4
2011,21217,TOR,1,0,0,0,0,1
2011,21218,NYI,3,1,0,0,0,4
2011,21218,PHI,3,2,2,0,0,7
2011,21219,CAR,0,1,1,0,0,2
2011,21219,TBL,3,1,2,0,0,6
2011,21220,FLA,0,0,1,0,0,1
2011,21220,WSH,0,0,0,0,0,0
2011,21221,BUF,0,3,2,0,0,5
2011,21221,CBJ,0,2,2,0,0,4
2011,21222,NSH,0,0,0,0,0,0
2011,21222,STL,0,1,1,0,0,2
2011,21223,CGY,0,2,0,0,0,2
2011,21223,VAN,0,0,2,1,0,3
2011,21224,ANA,2,1,0,0,0,3
2011,21224,LAK,0,1,0,0,0,1
2011,21225,PHX,0,0,1,0,0,1
2011,21225,SJS,0,2,1,0,0,3
2011,21226,BOS,1,0,1,0,0,2
2011,21226,NJD,1,0,2,0,0,3
2011,21227,ATL,1,0,1,0,0,2
2011,21227,PIT,0,4,1,0,0,5
2011,21228,COL,2,0,1,1,0,4
2011,21228,EDM,1,2,0,0,0,3
2011,21229,CHI,0,1,2,0,0,3
2011,21229,DET,0,2,2,0,0,4
2011,21230,DAL,2,1,0,0,0,3
2011,21230,MIN,1,2,2,0,0,5
2012,20001,BOS,1,0,0,0,0,1
2012,20001,PHI,2,0,0,0,0,2
2012,20002,MTL,0,0,0,0,0,0
2012,20002,TOR,0,1,1,0,0,2
2012,20003,PIT,2,1,0,0,1,4
2012,20003,VAN,1,1,1,0,0,3
2012,20004,CAR,1,0,0,0,0,1
2012,20004,TBL,0,2,3,0,0,5
2012,20005,DET,1,3,1,0,0,5
2012,20005,OTT,0,0,3,0,0,3
2012,20006,CBJ,0,1,1,0,0,2
2012,20006,NSH,0,2,1,0,0,3
2012,20007,ANA,0,1,0,0,0,1
2012,20007,BUF,2,2,0,0,0,4
2012,20008,CHI,0,0,1,0,0,1
2012,20008,DAL,0,2,0,0,0,2
2012,20009,LAK,1,0,1,1,0,3
2012,20009,NYR,1,0,1,0,0,2
2012,20010,BOS,0,2,2,0,0,4
2012,20010,TBL,0,1,0,0,0,1
2012,20011,OTT,0,0,5,0,0,5
2012,20011,TOR,2,2,2,0,0,6
2012,20012,NJD,0,0,0,0,0,0
2012,20012,PHI,1,0,2,0,0,3
2012,20013,CAR,0,1,2,0,0,3
2012,20013,WSH,0,2,1,1,0,4
2012,20014,FLA,2,0,0,0,0,2
2012,20014,NYI,0,0,0,0,0,0
2012,20015,NSH,1,0,3,0,0,4
2012,20015,STL,1,0,1,0,0,2
2012,20016,CBJ,0,1,1,0,0,2
2012,20016,MIN,2,2,0,0,0,4
2012,20017,CHI,1,2,2,0,0,5
2012,20017,DAL,0,1,1,0,0,2
2012,20018,COL,0,0,0,0,0,0
2012,20018,DET,0,1,2,0,0,3
2012,20019,CGY,1,0,2,0,0,3
2012,20019,PIT,0,4,1,0,0,5
2012,20020,ANA,1,0,0,0,1,2
2012,20020,NYR,0,0,1,0,0,1
2012,20021,PHX,0,1,2,0,0,3
2012,20021,SJS,2,4,0,0,0,6
2012,20022,BUF,0,3,1,0,0,4
2012,20022,LAK,0,1,1,0,0,2
2012,20023,MTL,1,1,3,0,0,5
2012,20023,WPG,0,0,1,0,0,1
2012,20024,EDM,0,0,1,0,1,2
2012,20024,PIT,1,0,0,0,0,1
2012,20025,BOS,0,0,0,0,0,0
2012,20025,COL,0,0,1,0,0,1
2012,20026,CAR,0,2,0,0,0,2
2012,20026,NJD,1,1,2,0,0,4
2012,20027,MIN,0,0,1,0,0,1
2012,20027,NYI,2,0,0,0,0,2
2012,20028,CGY,1,1,0,0,0,2
2012,20028,STL,1,2,2,0,0,5
2012,20029,TBL,2,1,2,0,0,5
2012,20029,WSH,2,1,2,0,1,6
2012,20030,CBJ,1,1,0,0,0,2
2012,20030,VAN,1,0,2,0,0,3
2012,20031,DAL,0,0,1,0,1,2
2012,20031,PHX,0,0,1,0,0,1
2012,20032,FLA,0,1,1,0,0,2
2012,20032,PIT,1,2,1,0,0,4
2012,20033,MIN,2,0,1,0,0,3
2012,20033,OTT,0,1,2,0,1,4
2012,20034,COL,1,0,1,0,1,3
2012,20034,CBJ,0,1,1,0,0,2
2012,20035,PHI,3,1,1,0,0,5
2012,20035,VAN,1,2,1,0,0,4
2012,20036,BOS,0,0,2,0,0,2
2012,20036,CAR,0,1,2,0,0,3
2012,20037,LAK,1,0,0,0,0,1
2012,20037,NJD,1,0,0,0,1,2
2012,20038,NYI,4,1,0,0,0,5
2012,20038,TBL,1,0,0,0,0,1
2012,20039,PIT,1,0,1,0,0,2
2012,20039,WSH,0,1,1,1,0,3
2012,20040,CGY,3,1,0,0,0,4
2012,20040,MTL,1,0,0,0,0,1
2012,20041,COL,2,1,4,0,0,7
2012,20041,OTT,1,0,0,0,0,1
2012,20042,DET,0,2,0,0,0,2
2012,20042,VAN,0,0,0,0,0,0
2012,20043,NSH,0,1,1,0,0,2
2012,20043,PHX,3,1,1,0,0,5
2012,20044,EDM,1,0,0,0,0,1
2012,20044,MIN,0,1,0,0,1,2
2012,20045,CHI,2,2,0,0,0,4
2012,20045,WPG,2,1,0,0,0,3
2012,20046,DAL,1,2,0,0,0,3
2012,20046,STL,0,1,1,0,0,2
2012,20047,BUF,2,0,1,0,0,3
2012,20047,CAR,2,1,1,0,0,4
2012,20048,ANA,1,0,0,0,0,1
2012,20048,SJS,0,0,0,0,0,0
2012,20049,CGY,2,0,0,0,0,2
2012,20049,TOR,0,2,1,0,0,3
2012,20050,COL,1,3,1,0,1,6
2012,20050,MTL,1,2,2,0,0,5
2012,20051,NYI,1,1,2,0,0,4
2012,20051,NYR,0,2,0,0,0,2
2012,20052,LAK,1,0,1,1,0,3
2012,20052,PHI,1,0,1,0,0,2
2012,20053,BUF,2,0,1,0,0,3
2012,20053,PIT,0,1,1,0,0,2
2012,20054,OTT,1,0,0,0,0,1
2012,20054,WSH,2,0,0,0,0,2
2012,20055,PHX,2,1,1,0,0,4
2012,20055,WPG,0,1,0,0,0,1
2012,20056,FLA,1,0,1,0,1,3
2012,20056,TBL,0,0,2,0,0,2
2012,20057,NSH,2,0,0,0,0,2
2012,20057,NJD,0,0,2,0,1,3
2012,20058,DET,0,1,1,1,0,3
2012,20058,MIN,1,1,0,0,0,2
2012,20059,CBJ,1,1,0,0,0,2
2012,20059,DAL,1,1,2,0,0,4
2012,20060,BOS,0,1,1,0,1,3
2012,20060,CHI,1,1,0,0,0,2
2012,20061,EDM,2,1,0,0,0,3
2012,20061,VAN,1,2,1,0,0,4
2012,20062,SJS,1,1,0,0,0,2
2012,20062,STL,1,0,3,0,0,4
2012,20063,ANA,1,0,3,0,0,4
2012,20063,STL,0,1,1,0,0,2
2012,20064,COL,0,2,0,1,0,3
2012,20064,TOR,0,1,1,0,0,2
2012,20065,FLA,2,2,3,0,0,7
2012,20065,TBL,2,1,1,0,0,4
2012,20066,PIT,0,1,0,0,0,1
2012,20066,WPG,2,0,0,0,0,2
2012,20067,EDM,0,0,3,0,0,3
2012,20067,NSH,0,1,0,0,0,1
2012,20068,ANA,2,0,1,0,0,3
2012,20068,SJS,0,1,1,0,0,2
2012,20069,BOS,0,0,1,0,0,1
2012,20069,CAR,1,1,2,0,0,4
2012,20070,FLA,0,0,0,0,0,0
2012,20070,WSH,1,0,2,0,0,3
2012,20071,CBJ,0,0,2,0,0,2
2012,20071,DAL,0,1,2,0,0,3
2012,20072,BUF,0,2,1,0,0,3
2012,20072,MTL,0,1,0,0,0,1
2012,20073,OTT,0,1,1,0,0,2
2012,20073,PHI,4,0,3,0,0,7
2012,20074,MIN,0,1,1,0,0,2
2012,20074,PIT,0,2,2,0,0,4
2012,20075,CGY,0,0,2,0,0,2
2012,20075,EDM,1,0,0,0,0,1
2012,20076,NYR,0,0,4,0,0,4
2012,20076,VAN,0,0,0,0,0,0
2012,20077,CHI,1,2,2,0,0,5
2012,20077,PHX,0,2,0,0,0,2
2012,20078,LAK,1,2,2,0,0,5
2012,20078,STL,0,0,0,0,0,0
2012,20079,TOR,1,0,2,0,1,4
2012,20079,WPG,1,2,0,0,0,3
2012,20080,BOS,3,0,3,0,0,6
2012,20080,TOR,1,0,1,0,0,2
2012,20081,PHI,1,0,1,0,0,2
2012,20081,WSH,2,0,3,0,0,5
2012,20082,MTL,0,0,1,0,0,1
2012,20082,PIT,1,1,1,0,0,3
2012,20083,OTT,0,2,2,0,0,4
2012,20083,WPG,1,0,0,0,0,1
2012,20084,NYI,0,0,1,0,0,1
2012,20084,TBL,1,1,2,0,0,4
2012,20085,BUF,0,2,1,0,0,3
2012,20085,FLA,0,0,0,0,0,0
2012,20086,CHI,1,0,2,0,0,3
2012,20086,COL,0,1,0,0,0,1
2012,20087,CGY,2,0,0,0,0,2
2012,20087,NYR,2,0,0,1,0,3
2012,20088,EDM,1,0,0,0,0,1
2012,20088,MIN,0,0,1,0,1,2
2012,20089,NSH,1,0,0,0,0,1
2012,20089,VAN,4,0,1,0,0,5
2012,20090,LAK,0,2,0,0,0,2
2012,20090,PHX,0,0,0,0,0,0
2012,20091,NJD,1,1,1,0,0,3
2012,20091,SJS,0,2,1,0,1,4
2012,20092,CBJ,1,0,1,0,0,2
2012,20092,DET,2,1,2,0,0,5
2012,20093,CAR,1,1,0,0,0,2
2012,20093,STL,0,2,0,1,0,3
2012,20094,ANA,0,1,0,0,0,1
2012,20094,DAL,2,0,1,0,0,3
2012,20095,CGY,0,0,0,0,0,0
2012,20095,NSH,0,1,1,0,0,2
2012,20096,MIN,1,1,0,0,0,2
2012,20096,VAN,0,1,1,1,0,3
2012,20097,BOS,0,0,2,0,0,2
2012,20097,SJS,1,1,2,0,0,4
2012,20098,MTL,1,1,2,0,0,4
2012,20098,TOR,1,2,1,1,0,5
2012,20099,CBJ,1,1,1,0,0,3
2012,20099,OTT,1,1,2,0,0,4
2012,20100,PHI,0,1,1,0,0,2
2012,20100,STL,2,1,1,0,0,4
2012,20101,NJD,0,0,1,0,0,1
2012,20101,PIT,1,0,3,0,0,4
2012,20102,DET,0,1,0,0,0,1
2012,20102,WSH,2,2,3,0,0,7
2012,20103,CAR,2,0,1,0,0,3
2012,20103,WPG,2,3,0,0,0,5
2012,20104,BUF,0,0,0,0,0,0
2012,20104,TBL,0,1,2,0,0,3
2012,20105,FLA,1,1,2,0,0,4
2012,20105,NYI,1,1,0,0,0,2
2012,20106,CHI,0,2,2,0,0,4
2012,20106,COL,1,2,1,0,1,5
2012,20107,EDM,0,1,1,0,0,2
2012,20107,NYR,0,0,0,0,0,0
2012,20108,DAL,0,0,0,0,0,0
2012,20108,LAK,0,0,1,0,0,1
2012,20109,ANA,2,1,1,0,0,4
2012,20109,PHX,2,3,0,0,0,5
2012,20110,PHI,1,1,2,0,0,4
2012,20110,TOR,1,0,1,0,0,2
2012,20111,FLA,1,0,1,0,0,2
2012,20111,MTL,1,0,0,0,0,1
2012,20112,NYR,0,1,1,0,0,2
2012,20112,WPG,0,1,0,0,0,1
2012,20113,BUF,2,0,1,0,0,3
2012,20113,TBL,2,1,1,0,0,4
2012,20114,NYI,0,0,0,0,0,0
2012,20114,PIT,1,1,1,0,0,3
2012,20115,CAR,0,0,2,0,0,2
2012,20115,OTT,0,2,0,0,1,3
2012,20116,CBJ,2,1,1,0,0,4
2012,20116,DET,1,0,0,0,0,1
2012,20117,NSH,0,0,1,0,0,1
2012,20117,SJS,1,0,2,0,0,3
2012,20118,ANA,0,2,0,0,0,2
2012,20118,CHI,0,1,1,0,1,3
2012,20119,EDM,0,3,0,0,0,3
2012,20119,VAN,0,1,1,0,0,2
2012,20120,DAL,1,0,1,0,1,3
2012,20120,PHX,1,0,1,0,0,2
2012,20121,LAK,0,0,0,0,0,0
2012,20121,NJD,0,3,0,0,0,3
2012,20122,MTL,1,2,2,0,0,5
2012,20122,PHI,1,0,0,0,0,1
2012,20123,CGY,1,2,1,0,0,4
2012,20123,COL,1,0,1,0,0,2
2012,20124,STL,0,1,2,0,0,3
2012,20124,VAN,0,0,0,0,0,0
2012,20125,BOS,1,0,0,0,0,1
2012,20125,MTL,0,1,1,0,0,2
2012,20126,BUF,1,1,2,0,0,4
2012,20126,CBJ,0,1,1,0,0,2
2012,20127,NYR,1,0,1,0,0,2
2012,20127,TOR,0,1,3,0,0,4
2012,20128,PHI,1,3,4,0,0,8
2012,20128,WPG,3,3,3,0,0,9
2012,20129,NYI,1,0,1,0,0,2
2012,20129,PIT,0,0,2,0,1,3
2012,20130,FLA,1,1,1,0,0,3
2012,20130,OTT,0,2,2,0,0,4
2012,20131,NSH,2,3,0,0,0,5
2012,20131,TBL,2,0,1,0,0,3
2012,20132,ANA,1,1,1,0,0,3
2012,20132,MIN,0,1,1,0,0,2
2012,20133,DAL,1,0,2,0,0,3
2012,20133,LAK,0,3,2,0,0,5
2012,20134,EDM,1,1,0,0,0,2
2012,20134,WSH,1,0,0,0,0,1
2012,20135,NJD,1,1,1,0,0,3
2012,20135,PHX,1,2,2,0,0,5
2012,20136,CAR,1,0,2,0,0,3
2012,20136,CHI,0,0,0,0,0,0
2012,20137,DET,1,1,0,0,0,2
2012,20137,SJS,0,3,1,0,0,4
2012,20138,COL,0,0,1,0,0,1
2012,20138,EDM,0,2,1,0,0,3
2012,20139,CGY,0,1,2,0,0,3
2012,20139,STL,0,0,1,0,0,1
2012,20140,NYR,0,2,2,0,0,4
2012,20140,OTT,1,0,3,0,1,5
2012,20141,BUF,0,1,1,0,0,2
2012,20141,FLA,0,1,2,0,0,3
2012,20142,PIT,0,2,1,0,0,3
2012,20142,TOR,1,1,2,0,0,4
2012,20143,BOS,0,1,1,0,0,2
2012,20143,MTL,2,1,1,0,0,4
2012,20144,NYI,0,2,0,0,0,2
2012,20144,SJS,1,1,0,1,0,3
2012,20145,CAR,0,1,0,0,0,1
2012,20145,PHI,1,0,4,0,0,5
2012,20146,TBL,0,1,0,0,0,1
2012,20146,WPG,0,0,0,0,0,0
2012,20147,ANA,0,0,0,0,0,0
2012,20147,NSH,2,0,1,0,0,3
2012,20148,DET,0,0,0,0,0,0
2012,20148,MIN,1,0,0,0,0,1
2012,20149,DAL,1,0,2,0,0,3
2012,20149,NJD,0,1,0,0,0,1
2012,20150,CHI,2,0,3,0,0,5
2012,20150,CBJ,1,1,0,0,0,2
2012,20151,LAK,0,1,1,0,0,2
2012,20151,PHX,0,2,0,1,0,3
2012,20152,VAN,3,1,3,0,0,7
2012,20152,WSH,1,3,0,0,0,4
2012,20153,ANA,1,0,0,0,0,1
2012,20153,CBJ,1,2,0,0,0,3
2012,20154,OTT,1,1,1,0,0,3
2012,20154,TOR,1,0,1,0,0,2
2012,20155,COL,1,1,1,0,0,3
2012,20155,LAK,1,1,0,0,0,2
2012,20156,EDM,1,3,0,0,0,4
2012,20156,STL,0,1,1,0,0,2
2012,20157,NYR,2,3,0,0,0,5
2012,20157,SJS,1,1,0,0,0,2
2012,20158,FLA,1,0,2,0,0,3
2012,20158,WPG,2,0,1,0,1,4
2012,20159,CHI,1,1,2,1,0,5
2012,20159,NSH,1,2,1,0,0,4
2012,20160,BOS,1,2,2,0,0,5
2012,20160,OTT,2,0,1,0,0,3
2012,20161,ANA,2,1,1,0,0,4
2012,20161,WSH,0,2,2,1,0,5
2012,20162,CAR,1,2,1,0,0,4
2012,20162,TBL,1,0,1,0,0,2
2012,20163,DET,1,0,0,0,0,1
2012,20163,MIN,0,0,1,1,0,2
2012,20164,CGY,0,0,1,0,0,1
2012,20164,VAN,3,2,0,0,0,5
2012,20165,BUF,0,1,1,0,0,2
2012,20165,PHI,3,0,0,0,0,3
2012,20166,NJD,1,2,0,0,0,3
2012,20166,TOR,2,3,0,0,0,5
2012,20167,COL,0,1,0,0,0,1
2012,20167,PHX,1,1,2,0,0,4
2012,20168,NYI,0,0,0,0,0,0
2012,20168,WPG,1,0,2,0,0,3
2012,20169,ANA,0,1,0,0,0,1
2012,20169,NYR,1,0,0,0,1,2
2012,20170,NJD,0,2,1,0,1,4
2012,20170,PHI,0,2,1,0,0,3
2012,20171,CBJ,0,1,0,0,0,1
2012,20171,TOR,2,2,0,0,0,4
2012,20172,CHI,1,1,0,0,1,3
2012,20172,FLA,0,1,1,0,0,2
2012,20173,CGY,1,1,2,0,0,4
2012,20173,DET,0,1,0,0,0,1
2012,20174,MIN,0,3,2,0,0,5
2012,20174,VAN,1,0,0,0,0,1
2012,20175,NSH,0,2,1,0,0,3
2012,20175,PHX,0,0,0,0,0,0
2012,20176,EDM,0,2,1,0,0,3
2012,20176,LAK,0,0,0,0,0,0
2012,20177,PIT,2,1,0,0,0,3
2012,20177,SJS,0,1,2,0,1,4
2012,20178,CAR,1,0,0,0,0,1
2012,20178,WSH,0,2,3,0,0,5
2012,20179,BUF,1,0,1,0,0,2
2012,20179,CGY,0,0,1,0,0,1
2012,20180,MTL,0,2,0,0,0,2
2012,20180,OTT,0,0,1,0,0,1
2012,20181,CHI,0,4,0,0,0,4
2012,20181,TBL,0,4,0,1,0,5
2012,20182,STL,1,1,1,0,0,3
2012,20182,VAN,1,0,1,0,0,2
2012,20183,COL,2,2,2,0,0,6
2012,20183,DAL,0,4,2,1,0,7
2012,20184,BOS,1,4,2,0,0,7
2012,20184,TOR,0,0,0,0,0,0
2012,20185,BUF,0,2,0,0,1,3
2012,20185,OTT,1,1,0,0,0,2
2012,20186,NJD,0,2,0,1,0,3
2012,20186,WPG,0,0,2,0,0,2
2012,20187,NYI,0,2,3,0,0,5
2012,20187,WSH,2,0,1,0,0,3
2012,20188,MTL,0,2,1,0,0,3
2012,20188,NYR,3,1,1,0,0,5
2012,20189,CBJ,0,0,2,0,0,2
2012,20189,PHI,5,3,1,0,0,9
2012,20190,ANA,0,0,0,0,0,0
2012,20190,DET,1,2,2,0,0,5
2012,20191,MIN,0,2,0,0,0,2
2012,20191,STL,0,0,1,0,0,1
2012,20192,EDM,0,0,2,0,0,2
2012,20192,PHX,0,2,2,0,0,4
2012,20193,LAK,0,1,1,0,0,2
2012,20193,PIT,1,0,1,0,1,3
2012,20194,NSH,0,1,2,1,0,4
2012,20194,SJS,0,2,1,0,0,3
2012,20195,CAR,1,0,1,0,0,2
2012,20195,DAL,3,2,0,0,0,5
2012,20196,FLA,3,0,0,0,0,3
2012,20196,TBL,0,2,1,0,1,4
2012,20197,NYR,0,1,2,0,0,3
2012,20197,WPG,0,0,0,0,0,0
2012,20198,CHI,1,1,0,0,0,2
2012,20198,VAN,1,4,1,0,0,6
2012,20199,CGY,1,1,0,0,0,2
2012,20199,COL,1,0,0,0,0,1
2012,20200,BOS,3,0,3,0,0,6
2012,20200,NYI,2,0,0,0,0,2
2012,20201,LAK,0,1,1,0,0,2
2012,20201,SJS,0,3,1,0,0,4
2012,20202,BUF,3,1,1,1,0,6
2012,20202,WPG,3,1,1,0,0,5
2012,20203,FLA,1,2,2,0,0,5
2012,20203,TOR,0,0,1,0,0,1
2012,20204,CAR,1,0,1,0,0,2
2012,20204,NJD,0,1,2,0,0,3
2012,20205,DAL,2,0,3,0,0,5
2012,20205,WSH,1,1,0,0,0,2
2012,20206,EDM,0,1,2,0,0,3
2012,20206,MTL,0,0,1,0,0,1
2012,20207,COL,0,1,1,0,0,2
2012,20207,DET,1,2,2,0,0,5
2012,20208,CHI,0,0,0,0,0,0
2012,20208,STL,1,1,1,0,0,3
2012,20209,CGY,0,0,0,0,0,0
2012,20209,MIN,1,1,1,0,0,3
2012,20210,LAK,2,2,0,0,0,4
2012,20210,NSH,2,0,1,0,0,3
2012,20211,NYR,0,2,1,0,0,3
2012,20211,OTT,0,1,1,0,0,2
2012,20212,PHI,0,1,0,0,0,1
2012,20212,TBL,0,0,1,1,0,2
2012,20213,ANA,1,1,0,0,0,2
2012,20213,NSH,2,1,1,0,0,4
2012,20214,BOS,2,2,2,0,0,6
2012,20214,EDM,2,0,1,0,0,3
2012,20215,CHI,2,3,1,0,0,6
2012,20215,CBJ,1,0,2,0,0,3
2012,20216,STL,0,1,1,0,0,2
2012,20216,TOR,2,0,0,0,1,3
2012,20217,FLA,2,2,1,0,0,5
2012,20217,WPG,0,0,2,0,0,2
2012,20218,COL,0,1,2,1,0,4
2012,20218,NYI,1,2,0,0,0,3
2012,20219,MTL,0,2,0,1,0,3
2012,20219,PHX,1,0,1,0,0,2
2012,20220,LAK,0,1,1,0,0,2
2012,20220,VAN,3,0,0,0,0,3
2012,20221,MIN,0,0,1,0,0,1
2012,20221,SJS,0,3,0,0,0,3
2012,20222,NJD,1,0,0,0,0,1
2012,20222,WSH,0,1,2,0,0,3
2012,20223,CAR,0,1,0,0,0,1
2012,20223,NYR,1,0,4,0,0,5
2012,20224,DAL,1,0,0,0,0,1
2012,20224,PIT,0,1,2,0,0,3
2012,20225,BUF,3,0,2,0,0,5
2012,20225,OTT,1,0,0,0,0,1
2012,20226,DET,1,1,1,0,0,3
2012,20226,EDM,0,0,0,0,0,0
2012,20227,CGY,0,0,1,0,0,1
2012,20227,CHI,1,1,2,0,0,4
2012,20228,ANA,0,4,0,0,0,4
2012,20228,VAN,0,0,3,0,0,3
2012,20229,BOS,0,3,3,0,0,6
2012,20229,BUF,1,0,1,0,0,2
2012,20230,OTT,0,2,3,0,0,5
2012,20230,TOR,1,0,1,0,0,2
2012,20231,NJD,0,2,0,0,1,3
2012,20231,WSH,2,0,0,0,0,2
2012,20232,CAR,1,2,2,0,0,5
2012,20232,PIT,0,0,3,0,0,3
2012,20233,DAL,1,1,0,0,0,2
2012,20233,DET,1,1,3,0,0,5
2012,20234,CBJ,1,0,1,0,0,2
2012,20234,WPG,0,0,1,0,0,1
2012,20235,MTL,1,0,0,1,0,2
2012,20235,NSH,0,1,0,0,0,1
2012,20236,STL,1,1,1,0,0,3
2012,20236,TBL,0,0,0,0,0,0
2012,20237,CGY,3,1,0,0,0,4
2012,20237,COL,0,1,2,0,0,3
2012,20238,LAK,1,4,0,0,0,5
2012,20238,MIN,0,0,2,0,0,2
2012,20239,PHX,2,0,1,0,0,3
2012,20239,SJS,0,0,0,0,0,0
2012,20240,FLA,0,1,1,0,0,2
2012,20240,PHI,1,1,1,0,0,3
2012,20241,CHI,3,2,1,0,0,6
2012,20241,EDM,1,2,0,0,0,3
2012,20242,ANA,0,1,1,0,0,2
2012,20242,MIN,3,0,0,0,0,3
2012,20243,NYI,0,1,0,0,0,1
2012,20243,VAN,1,1,2,0,0,4
2012,20244,CAR,1,1,1,0,0,3
2012,20244,PHI,2,2,1,0,0,5
2012,20245,BUF,0,0,2,0,1,3
2012,20245,MTL,0,2,0,0,0,2
2012,20246,TBL,0,1,1,0,0,2
2012,20246,WPG,2,2,1,0,0,5
2012,20247,BOS,0,1,3,0,0,4
2012,20247,NJD,0,1,2,0,0,3
2012,20248,PHX,2,0,0,0,1,3
2012,20248,TOR,0,0,2,0,0,2
2012,20249,NYI,1,0,1,0,0,2
2012,20249,NYR,1,1,2,0,0,4
2012,20250,COL,3,0,0,0,0,3
2012,20250,PIT,1,1,4,0,0,6
2012,20251,CBJ,2,0,0,0,0,2
2012,20251,MIN,0,2,2,0,0,4
2012,20252,DET,1,0,0,0,0,1
2012,20252,STL,1,1,0,0,0,2
2012,20253,NSH,0,0,3,0,0,3
2012,20253,WSH,0,0,1,0,0,1
2012,20254,DAL,0,0,0,0,0,0
2012,20254,FLA,2,2,2,0,0,6
2012,20255,CGY,0,1,0,0,0,1
2012,20255,OTT,0,1,2,0,0,3
2012,20256,CAR,0,0,0,0,0,0
2012,20256,MTL,2,2,0,0,0,4
2012,20257,BUF,1,0,2,0,0,3
2012,20257,NJD,2,1,2,0,0,5
2012,20258,CHI,0,2,3,0,0,5
2012,20258,VAN,0,1,0,0,0,1
2012,20259,CAR,0,0,0,0,0,0
2012,20259,TBL,0,0,0,0,0,0
2012,20260,BOS,0,1,0,0,1,2
2012,20260,CBJ,0,1,0,0,0,1
2012,20261,MTL,0,2,1,0,0,3
2012,20261,NYI,0,4,0,0,0,4
2012,20262,PHI,0,1,1,0,0,2
2012,20262,PHX,0,0,1,0,0,1
2012,20263,PIT,0,0,1,0,0,1
2012,20263,TBL,1,1,2,0,0,4
2012,20264,FLA,1,0,0,0,0,1
2012,20264,STL,1,1,2,0,0,4
2012,20265,NSH,1,1,2,0,0,4
2012,20265,TOR,0,1,0,0,0,1
2012,20266,COL,0,0,0,0,0,0
2012,20266,MIN,0,0,1,0,0,1
2012,20267,WSH,1,0,0,0,0,1
2012,20267,WPG,1,3,0,0,0,4
2012,20268,EDM,0,1,1,0,0,2
2012,20268,OTT,3,1,1,0,0,5
2012,20269,ANA,0,1,2,0,0,3
2012,20269,LAK,0,2,3,0,0,5
2012,20270,DET,1,0,1,0,0,2
2012,20270,SJS,1,3,1,0,0,5
2012,20271,BUF,1,0,0,0,0,1
2012,20271,CAR,0,0,0,0,0,0
2012,20272,COL,1,0,2,0,0,3
2012,20272,DAL,0,0,0,0,0,0
2012,20273,CGY,1,3,1,0,0,5
2012,20273,CHI,1,1,0,0,0,2
2012,20274,PHI,1,1,2,0,0,4
2012,20274,WPG,3,2,1,0,0,6
2012,20275,DET,1,2,1,0,0,4
2012,20275,LAK,1,0,0,0,0,1
2012,20276,BUF,1,1,0,0,0,2
2012,20276,PHX,1,2,1,0,0,4
2012,20277,TOR,2,4,1,0,0,7
2012,20277,WSH,1,0,0,0,0,1
2012,20278,MTL,1,1,2,0,0,4
2012,20278,NYR,0,0,0,0,0,0
2012,20279,BOS,3,0,3,0,0,6
2012,20279,NYI,0,0,0,0,0,0
2012,20280,NJD,0,3,1,0,0,4
2012,20280,TBL,0,0,2,0,0,2
2012,20281,FLA,1,1,1,0,0,3
2012,20281,PIT,1,1,0,0,0,2
2012,20282,CBJ,0,2,1,1,0,4
2012,20282,NSH,1,1,1,0,0,3
2012,20283,MIN,0,1,1,0,1,3
2012,20283,STL,1,0,1,0,0,2
2012,20284,DAL,0,0,1,0,0,1
2012,20284,SJS,1,2,1,0,0,4
2012,20285,CHI,1,1,0,0,0,2
2012,20285,EDM,5,3,1,0,0,9
2012,20286,CAR,1,1,1,0,0,3
2012,20286,TOR,0,0,2,0,0,2
2012,20287,COL,1,0,0,0,0,1
2012,20287,SJS,1,2,1,0,0,4
2012,20288,ANA,0,2,0,0,0,2
2012,20288,DET,1,2,1,0,0,4
2012,20289,OTT,0,0,1,0,0,1
2012,20289,VAN,0,1,0,1,0,2
2012,20290,CAR,2,2,0,0,0,4
2012,20290,PHI,0,2,0,0,0,2
2012,20291,NYI,0,0,0,0,0,0
2012,20291,PIT,2,2,1,0,0,5
2012,20292,PHX,1,1,1,0,0,3
2012,20292,WSH,0,2,2,0,0,4
2012,20293,CGY,0,1,0,0,0,1
2012,20293,CBJ,2,1,1,0,0,4
2012,20294,BOS,1,0,0,0,0,1
2012,20294,MTL,0,0,0,0,0,0
2012,20295,FLA,0,2,2,0,0,4
2012,20295,NJD,3,0,0,0,0,3
2012,20296,DAL,1,2,1,0,0,4
2012,20296,EDM,0,1,0,0,0,1
2012,20297,TBL,1,0,0,0,0,1
2012,20297,TOR,3,1,3,0,0,7
2012,20298,LAK,0,1,2,0,0,3
2012,20298,STL,1,0,1,0,0,2
2012,20299,EDM,3,0,3,0,0,6
2012,20299,NSH,0,0,2,0,0,2
2012,20300,BOS,0,2,1,0,1,4
2012,20300,BUF,2,1,0,0,0,3
2012,20301,CBJ,0,0,1,0,0,1
2012,20301,NJD,0,1,0,0,1,2
2012,20302,NYI,3,0,0,0,0,3
2012,20302,PHI,1,1,1,1,0,4
2012,20303,PIT,0,0,2,0,0,2
2012,20303,STL,1,0,1,1,0,3
2012,20304,WSH,2,1,0,1,0,4
2012,20304,WPG,2,0,1,0,0,3
2012,20305,CAR,2,0,1,0,0,3
2012,20305,MTL,0,1,2,0,1,4
2012,20306,CGY,0,2,1,0,0,3
2012,20306,DET,1,1,3,0,0,5
2012,20307,FLA,1,1,0,0,0,2
2012,20307,NYR,0,1,0,0,0,1
2012,20308,MIN,0,0,3,0,0,3
2012,20308,NSH,1,0,1,0,0,2
2012,20309,DAL,0,0,2,1,0,3
2012,20309,LAK,0,2,0,0,0,2
2012,20310,COL,0,0,0,0,0,0
2012,20310,VAN,1,1,1,0,0,3
2012,20311,ANA,1,0,1,0,0,2
2012,20311,PHX,2,1,1,0,0,4
2012,20312,CHI,0,0,0,0,0,0
2012,20312,SJS,0,1,0,0,0,1
2012,20313,BOS,0,1,1,0,0,2
2012,20313,DET,1,1,0,0,1,3
2012,20314,NJD,0,1,0,0,0,1
2012,20314,NYI,0,0,0,0,0,0
2012,20315,MTL,1,0,0,0,0,1
2012,20315,PHI,0,3,0,0,0,3
2012,20316,EDM,2,1,2,0,0,5
2012,20316,MIN,1,1,0,0,0,2
2012,20317,NYR,0,4,2,0,0,6
2012,20317,WSH,0,2,1,0,0,3
2012,20318,ANA,3,1,1,0,0,5
2012,20318,CHI,2,0,4,0,0,6
2012,20319,OTT,1,1,1,0,0,3
2012,20319,PIT,4,1,1,0,0,6
2012,20320,CAR,0,1,0,0,0,1
2012,20320,WPG,1,1,1,0,0,3
2012,20321,BUF,0,1,0,0,0,1
2012,20321,CBJ,2,3,0,0,0,5
2012,20322,FLA,0,1,0,0,0,1
2012,20322,TBL,0,0,1,1,0,2
2012,20323,CGY,0,0,0,0,0,0
2012,20323,STL,1,0,1,0,0,2
2012,20324,DAL,1,1,1,0,0,3
2012,20324,TOR,2,0,1,0,1,4
2012,20325,PHX,0,0,0,0,0,0
2012,20325,VAN,0,3,2,0,0,5
2012,20326,NJD,0,1,1,0,0,2
2012,20326,NYI,1,1,1,0,0,3
2012,20327,NYR,0,1,1,0,0,2
2012,20327,PHI,0,0,0,0,0,0
2012,20328,COL,1,0,4,0,0,5
2012,20328,EDM,1,1,0,0,0,2
2012,20329,BOS,1,2,1,0,0,4
2012,20329,WPG,2,0,0,0,0,2
2012,20330,BUF,2,1,2,0,0,5
2012,20330,WSH,0,1,0,0,0,1
2012,20331,MTL,2,1,0,0,0,3
2012,20331,PIT,1,1,1,1,0,4
2012,20332,FLA,0,0,1,0,0,1
2012,20332,TBL,1,3,1,0,0,5
2012,20333,DET,1,2,1,0,0,4
2012,20333,NSH,0,0,1,0,0,1
2012,20334,DAL,0,0,0,0,0,0
2012,20334,PHX,1,1,1,0,0,3
2012,20335,SJS,1,0,1,0,0,2
2012,20335,VAN,1,2,0,0,0,3
2012,20336,CHI,1,1,0,0,0,2
2012,20336,LAK,0,1,0,0,0,1
2012,20337,CAR,1,0,2,0,0,3
2012,20337,OTT,2,1,1,0,0,4
2012,20338,CBJ,0,1,0,0,0,1
2012,20338,STL,0,1,1,0,0,2
2012,20339,CGY,3,0,2,0,0,5
2012,20339,MIN,2,0,0,0,0,2
2012,20340,ANA,1,0,1,0,0,2
2012,20340,TOR,2,1,2,0,0,5
2012,20341,MIN,0,2,1,0,0,3
2012,20341,TBL,0,1,0,0,0,1
2012,20342,COL,0,0,1,0,0,1
2012,20342,DAL,1,0,2,0,0,3
2012,20343,EDM,1,0,0,0,0,1
2012,20343,NSH,0,1,1,0,0,2
2012,20344,LAK,1,1,0,0,0,2
2012,20344,SJS,0,0,0,0,0,0
2012,20345,BUF,0,0,1,0,0,1
2012,20345,NYI,1,0,1,0,0,2
2012,20346,NYR,0,4,0,0,0,4
2012,20346,PIT,1,1,1,0,0,3
2012,20347,STL,1,1,0,0,0,2
2012,20347,WSH,1,0,0,0,0,1
2012,20348,CAR,0,1,0,0,0,1
2012,20348,FLA,0,1,2,0,0,3
2012,20349,OTT,1,2,3,0,0,6
2012,20349,WPG,0,2,2,0,0,4
2012,20350,CHI,0,0,1,0,0,1
2012,20350,PHX,1,1,2,0,0,4
2012,20351,CGY,1,0,0,0,0,1
2012,20351,NSH,0,0,0,0,0,0
2012,20352,CBJ,0,0,1,0,0,1
2012,20352,VAN,2,0,2,0,0,4
2012,20353,BOS,1,2,3,0,0,6
2012,20353,TOR,1,1,1,0,0,3
2012,20354,DET,2,0,2,0,0,4
2012,20354,TBL,0,2,0,0,0,2
2012,20355,COL,3,0,3,0,0,6
2012,20355,NJD,0,1,0,0,0,1
2012,20356,EDM,1,1,0,0,0,2
2012,20356,MIN,0,2,0,0,1,3
2012,20357,ANA,1,1,2,0,0,4
2012,20357,MTL,1,0,0,0,0,1
2012,20358,PIT,1,0,1,0,0,2
2012,20358,WSH,0,1,0,0,0,1
2012,20359,CAR,2,1,0,0,0,3
2012,20359,NYR,1,3,1,0,0,5
2012,20360,PHX,0,0,0,0,0,0
2012,20360,WPG,1,0,0,0,0,1
2012,20361,DAL,1,0,2,0,0,3
2012,20361,OTT,1,0,1,0,0,2
2012,20362,CGY,1,1,1,0,0,3
2012,20362,CBJ,1,0,2,0,1,4
2012,20363,NSH,3,2,1,0,0,6
2012,20363,VAN,1,4,0,0,0,5
2012,20364,FLA,0,1,0,0,0,1
2012,20364,LAK,1,1,0,0,0,2
2012,20365,MTL,1,1,1,0,0,3
2012,20365,SJS,1,1,1,0,1,4
2012,20366,BUF,0,0,1,0,0,1
2012,20366,DET,3,0,1,0,0,4
2012,20367,MIN,3,0,1,0,0,4
2012,20367,NJD,2,0,0,0,0,2
2012,20368,CHI,1,2,1,0,1,5
2012,20368,NYI,2,0,2,0,0,4
2012,20369,COL,1,0,1,0,1,3
2012,20369,STL,1,1,0,0,0,2
2012,20370,CBJ,1,1,1,0,0,3
2012,20370,EDM,1,0,5,0,0,6
2012,20371,ANA,2,1,0,0,0,3
2012,20371,PHI,0,1,2,1,0,4
2012,20372,LAK,0,1,0,0,0,1
2012,20372,MTL,1,1,0,0,0,2
2012,20373,BOS,0,2,2,0,0,4
2012,20373,TOR,0,1,0,0,0,1
2012,20374,OTT,0,1,1,0,0,2
2012,20374,WSH,1,0,1,1,0,3
2012,20375,CAR,0,1,1,0,0,2
2012,20375,PIT,0,1,2,0,0,3
2012,20376,NJD,1,1,0,0,0,2
2012,20376,WPG,1,1,2,0,0,4
2012,20377,NYR,0,1,3,0,0,4
2012,20377,TBL,1,1,0,0,0,2
2012,20378,CHI,0,3,2,0,0,5
2012,20378,STL,1,1,0,0,0,2
2012,20379,BUF,2,0,1,0,0,3
2012,20379,NSH,0,0,2,0,0,2
2012,20380,PHI,4,0,0,0,0,4
2012,20380,PHX,0,1,1,0,0,2
2012,20381,DAL,0,4,0,0,0,4
2012,20381,NYI,2,3,0,0,0,5
2012,20382,CGY,2,0,3,0,0,5
2012,20382,EDM,2,0,1,0,0,3
2012,20383,FLA,1,3,1,0,0,5
2012,20383,SJS,2,0,1,0,0,3
2012,20384,COL,0,2,2,0,0,4
2012,20384,DET,1,0,1,0,0,2
2012,20385,ANA,2,0,1,0,0,3
2012,20385,MIN,1,2,2,0,0,5
2012,20386,CGY,1,0,0,0,0,1
2012,20386,VAN,0,2,3,0,0,5
2012,20387,NYR,0,2,0,0,0,2
2012,20387,TOR,1,2,1,0,0,4
2012,20388,BOS,0,2,1,0,0,3
2012,20388,PIT,0,0,1,0,0,1
2012,20389,OTT,0,1,3,0,0,4
2012,20389,TBL,0,1,1,0,0,2
2012,20390,FLA,3,2,0,0,0,5
2012,20390,WSH,1,1,2,0,0,4
2012,20391,CHI,0,3,0,0,0,3
2012,20391,PHX,2,1,0,0,1,4
2012,20392,NJD,2,0,0,1,0,3
2012,20392,TOR,0,1,1,0,0,2
2012,20393,NYI,3,0,2,0,0,5
2012,20393,TBL,1,0,0,0,0,1
2012,20394,CBJ,1,1,0,0,1,3
2012,20394,MTL,1,0,1,0,0,2
2012,20395,DET,0,1,1,0,0,2
2012,20395,STL,0,1,2,0,0,3
2012,20396,NSH,1,0,1,0,0,2
2012,20396,PHX,1,0,2,0,0,3
2012,20397,BOS,0,0,1,0,0,1
2012,20397,WPG,1,0,1,0,0,2
2012,20398,CGY,2,2,3,0,0,7
2012,20398,CAR,0,2,4,0,0,6
2012,20399,COL,0,0,0,0,0,0
2012,20399,VAN,1,1,4,0,0,6
2012,20400,ANA,2,0,1,0,0,3
2012,20400,LAK,0,1,1,0,0,2
2012,20401,MIN,2,0,0,0,0,2
2012,20401,SJS,1,0,0,0,0,1
2012,20402,OTT,0,2,1,0,0,3
2012,20402,WSH,0,1,4,0,0,5
2012,20403,BUF,3,0,1,0,0,4
2012,20403,PHI,1,3,0,1,0,5
2012,20404,CAR,1,3,1,0,0,5
2012,20404,EDM,1,1,1,0,0,3
2012,20405,BOS,0,0,0,0,0,0
2012,20405,FLA,0,0,2,0,0,2
2012,20406,NJD,0,1,3,0,1,5
2012,20406,OTT,2,1,1,0,0,4
2012,20407,CHI,1,1,0,1,0,3
2012,20407,NYI,0,1,1,0,0,2
2012,20408,NYR,1,1,0,0,0,2
2012,20408,TBL,0,1,1,0,1,3
2012,20409,PHI,1,2,0,0,0,3
2012,20409,PIT,0,1,1,0,0,2
2012,20410,CBJ,1,1,1,0,0,3
2012,20410,NSH,0,1,2,1,0,4
2012,20411,MTL,2,1,0,0,0,3
2012,20411,VAN,0,1,2,0,1,4
2012,20412,DET,5,0,0,0,0,5
2012,20412,PHX,0,1,1,0,0,2
2012,20413,ANA,1,0,1,0,0,2
2012,20413,STL,1,2,1,0,0,4
2012,20414,CGY,0,0,3,0,0,3
2012,20414,COL,0,1,1,0,0,2
2012,20415,LAK,0,0,2,0,0,2
2012,20415,MIN,1,2,1,0,0,4
2012,20416,DAL,1,1,0,0,0,2
2012,20416,SJS,2,3,0,0,0,5
2012,20417,TOR,0,1,1,0,0,2
2012,20417,WSH,1,2,1,0,0,4
2012,20418,BUF,1,0,0,1,0,2
2012,20418,FLA,0,1,0,0,0,1
2012,20419,CAR,0,0,2,0,0,2
2012,20419,WPG,2,2,0,0,0,4
2012,20420,COL,0,1,0,0,0,1
2012,20420,EDM,2,2,0,0,0,4
2012,20421,MTL,0,1,1,0,0,2
2012,20421,NJD,0,0,1,0,0,1
2012,20422,BUF,0,1,0,0,0,1
2012,20422,NYR,0,2,2,0,0,4
2012,20423,OTT,0,1,0,0,0,1
2012,20423,VAN,2,1,1,0,0,4
2012,20424,NYI,2,1,0,0,0,3
2012,20424,PIT,2,2,2,0,0,6
2012,20425,PHI,0,3,2,0,0,5
2012,20425,TBL,1,0,1,0,0,2
2012,20426,DET,2,4,1,0,0,7
2012,20426,WPG,1,0,0,0,0,1
2012,20427,BOS,2,1,2,0,0,5
2012,20427,CBJ,2,1,0,0,0,3
2012,20428,SJS,0,0,0,0,0,0
2012,20428,STL,1,0,0,0,0,1
2012,20429,ANA,0,1,1,0,0,2
2012,20429,NSH,0,1,2,0,0,3
2012,20430,MIN,1,2,1,0,0,4
2012,20430,PHX,0,0,1,0,0,1
2012,20431,CGY,0,2,1,0,0,3
2012,20431,EDM,0,0,0,0,0,0
2012,20432,DAL,1,1,0,0,0,2
2012,20432,LAK,0,1,0,0,0,1
2012,20433,FLA,1,0,0,0,0,1
2012,20433,NYR,2,4,0,0,0,6
2012,20434,CHI,0,1,1,1,0,3
2012,20434,SJS,1,1,0,0,0,2
2012,20435,NJD,2,3,0,0,0,5
2012,20435,TBL,2,0,2,0,0,4
2012,20436,BOS,1,1,1,0,0,3
2012,20436,LAK,0,0,0,0,0,0
2012,20437,BUF,2,0,0,0,0,2
2012,20437,OTT,1,0,1,1,0,3
2012,20438,CAR,0,0,1,0,0,1
2012,20438,TOR,0,0,1,1,0,2
2012,20439,DAL,0,0,1,0,0,1
2012,20439,NYR,0,0,0,0,0,0
2012,20440,DET,0,1,3,0,0,4
2012,20440,PIT,1,0,0,0,0,1
2012,20441,PHI,1,3,1,0,0,5
2012,20441,WSH,0,0,1,0,0,1
2012,20442,CBJ,1,0,0,0,1,2
2012,20442,VAN,0,0,1,0,0,1
2012,20443,MTL,2,0,3,0,0,5
2012,20443,NYI,1,0,2,0,0,3
2012,20444,FLA,1,1,0,0,0,2
2012,20444,NJD,0,1,1,0,1,3
2012,20445,CGY,0,1,0,0,0,1
2012,20445,NSH,1,0,1,0,0,2
2012,20446,MIN,0,1,0,0,0,1
2012,20446,WPG,0,1,1,0,0,2
2012,20447,COL,1,0,2,0,1,4
2012,20447,SJS,0,2,1,0,0,3
2012,20448,BOS,1,1,3,0,0,5
2012,20448,OTT,0,1,1,0,0,2
2012,20449,CHI,0,2,1,0,1,4
2012,20449,MIN,0,2,1,0,0,3
2012,20450,ANA,1,2,1,0,0,4
2012,20450,PHX,0,1,0,0,0,1
2012,20451,DAL,1,0,2,0,0,3
2012,20451,NYI,1,1,0,0,0,2
2012,20452,CAR,0,2,2,0,0,4
2012,20452,VAN,1,1,1,0,0,3
2012,20453,CBJ,0,1,0,0,0,1
2012,20453,LAK,0,0,2,0,0,2
2012,20454,MTL,0,3,0,0,0,3
2012,20454,PHI,1,2,1,0,0,4
2012,20455,CGY,1,1,2,0,0,4
2012,20455,TBL,1,3,0,1,0,5
2012,20456,NYR,0,1,0,0,0,1
2012,20456,STL,2,0,2,0,0,4
2012,20457,DET,1,2,0,0,0,3
2012,20457,NSH,1,1,2,0,0,4
2012,20458,WSH,0,0,1,0,0,1
2012,20458,WPG,0,0,0,0,0,0
2012,20459,EDM,0,1,1,0,0,2
2012,20459,PHX,1,1,2,0,0,4
2012,20460,COL,2,2,0,0,0,4
2012,20460,SJS,1,1,3,0,0,5
2012,20461,DAL,1,1,1,0,0,3
2012,20461,NJD,1,3,2,0,0,6
2012,20462,BUF,0,4,1,0,0,5
2012,20462,TOR,0,2,2,0,0,4
2012,20463,OTT,0,5,1,0,0,6
2012,20463,PIT,0,3,1,0,0,4
2012,20464,CGY,1,0,1,0,0,2
2012,20464,FLA,1,0,1,0,1,3
2012,20465,ANA,0,0,1,0,0,1
2012,20465,CHI,1,2,1,0,0,4
2012,20466,BOS,4,1,1,0,0,6
2012,20466,PHI,0,0,0,0,0,0
2012,20467,TOR,1,1,1,0,0,3
2012,20467,VAN,1,2,2,0,0,5
2012,20468,MTL,0,3,0,0,0,3
2012,20468,NJD,1,2,2,0,0,5
2012,20469,BUF,1,0,2,0,0,3
2012,20469,PIT,4,2,2,0,0,8
2012,20470,ANA,2,0,1,0,0,3
2012,20470,WPG,2,2,1,0,0,5
2012,20471,DET,4,2,2,0,0,8
2012,20471,LAK,1,1,0,0,0,2
2012,20472,CBJ,0,2,0,0,0,2
2012,20472,TBL,2,1,0,0,0,3
2012,20473,NSH,0,0,1,0,1,2
2012,20473,STL,0,0,1,0,0,1
2012,20474,MIN,0,0,1,0,0,1
2012,20474,NYI,0,1,0,0,1,2
2012,20475,NYR,1,0,2,0,0,3
2012,20475,PHX,1,1,0,0,0,2
2012,20476,COL,1,1,0,0,0,2
2012,20476,WSH,0,1,0,0,0,1
2012,20477,EDM,1,1,0,0,0,2
2012,20477,SJS,1,1,1,0,0,3
2012,20478,CAR,1,1,0,0,0,2
2012,20478,FLA,1,0,1,1,0,3
2012,20479,CGY,0,0,2,0,0,2
2012,20479,CHI,1,2,1,0,0,4
2012,20480,CBJ,1,2,1,0,0,4
2012,20480,STL,2,0,4,0,0,6
2012,20481,BOS,1,1,1,0,0,3
2012,20481,MTL,1,0,1,0,0,2
2012,20482,LAK,1,1,0,0,1,3
2012,20482,TOR,1,0,1,0,0,2
2012,20483,ANA,0,3,0,0,0,3
2012,20483,DAL,1,2,2,0,0,5
2012,20484,COL,0,2,0,0,1,3
2012,20484,PHI,1,0,1,0,0,2
2012,20485,DET,1,1,1,0,0,3
2012,20485,EDM,0,2,0,0,0,2
2012,20486,MIN,0,0,0,0,0,0
2012,20486,VAN,1,2,1,0,0,4
2012,20487,NJD,1,0,0,0,0,1
2012,20487,NYR,0,1,3,0,0,4
2012,20488,CHI,0,0,2,0,0,2
2012,20488,PIT,1,2,0,0,0,3
2012,20489,NSH,0,0,1,0,0,1
2012,20489,WSH,2,0,2,0,0,4
2012,20490,BUF,0,1,0,0,0,1
2012,20490,OTT,1,0,3,0,0,4
2012,20491,FLA,0,1,0,0,0,1
2012,20491,PHX,1,1,0,0,0,2
2012,20492,NYI,1,1,0,0,1,3
2012,20492,WPG,1,1,0,0,0,2
2012,20493,CGY,1,1,0,0,0,2
2012,20493,MIN,1,0,0,0,0,1
2012,20494,CAR,1,2,0,0,0,3
2012,20494,PHX,1,1,2,0,0,4
2012,20495,CHI,0,2,3,0,0,5
2012,20495,MTL,0,1,0,0,0,1
2012,20496,DAL,1,0,0,0,0,1
2012,20496,PHI,2,1,1,0,0,4
2012,20497,COL,2,1,0,0,0,3
2012,20497,STL,0,2,0,0,0,2
2012,20498,DET,1,1,0,0,0,2
2012,20498,VAN,3,0,1,0,0,4
2012,20499,SJS,5,0,2,0,0,7
2012,20499,TBL,1,0,1,0,0,2
2012,20500,BUF,0,1,1,0,0,2
2012,20500,TOR,0,2,1,0,0,3
2012,20501,NYI,0,1,1,0,0,2
2012,20501,NYR,1,2,1,0,0,4
2012,20502,FLA,0,1,2,0,0,3
2012,20502,OTT,1,0,2,1,0,4
2012,20503,CBJ,4,1,0,0,0,5
2012,20503,NSH,1,3,2,0,0,6
2012,20504,MTL,0,0,0,0,0,0
2012,20504,WPG,2,1,1,0,0,4
2012,20505,CGY,1,2,0,0,0,3
2012,20505,DET,0,0,2,0,0,2
2012,20506,EDM,2,2,0,0,0,4
2012,20506,MIN,0,0,1,0,0,1
2012,20507,ANA,0,1,1,0,0,2
2012,20507,LAK,0,1,1,0,1,3
2012,20508,BOS,4,2,2,0,0,8
2012,20508,FLA,0,0,0,0,0,0
2012,20509,NJD,0,3,0,0,1,4
2012,20509,WSH,0,0,3,0,0,3
2012,20510,NYI,1,1,1,0,0,3
2012,20510,TOR,3,1,1,0,0,5
2012,20511,NYR,0,2,2,0,0,4
2012,20511,PHI,0,0,2,0,0,2
2012,20512,CAR,1,0,0,1,0,2
2012,20512,OTT,1,0,0,0,0,1
2012,20513,PIT,1,0,3,0,0,4
2012,20513,WPG,0,1,0,0,0,1
2012,20514,DAL,3,1,2,0,0,6
2012,20514,NSH,0,2,1,0,0,3
2012,20515,COL,0,1,0,1,0,2
2012,20515,TBL,1,0,0,0,0,1
2012,20516,PHX,0,1,1,0,0,2
2012,20516,STL,0,2,1,0,0,3
2012,20517,CGY,0,0,3,0,0,3
2012,20517,VAN,0,0,1,0,0,1
2012,20518,LAK,0,1,0,0,0,1
2012,20518,SJS,0,1,0,0,1,2
2012,20519,COL,0,2,2,0,0,4
2012,20519,MIN,1,1,0,0,0,2
2012,20520,BUF,4,0,0,0,0,4
2012,20520,WSH,0,1,1,0,0,2
2012,20521,NYI,0,0,0,0,0,0
2012,20521,NYR,0,1,2,0,0,3
2012,20522,CAR,1,2,1,0,0,4
2012,20522,NJD,0,0,2,0,0,2
2012,20523,DAL,0,1,2,0,0,3
2012,20523,STL,1,2,2,0,0,5
2012,20524,DET,1,2,1,0,0,4
2012,20524,NSH,0,0,1,0,0,1
2012,20525,CHI,0,3,1,0,0,4
2012,20525,CBJ,0,0,1,0,0,1
2012,20526,EDM,0,2,1,0,0,3
2012,20526,VAN,3,1,1,0,0,5
2012,20527,LAK,2,0,2,0,0,4
2012,20527,PHX,1,1,1,0,0,3
2012,20528,ANA,1,2,0,0,0,3
2012,20528,SJS,1,1,0,0,0,2
2012,20529,CAR,1,0,1,0,0,2
2012,20529,PIT,0,1,3,0,0,4
2012,20530,CGY,0,0,1,0,1,2
2012,20530,CBJ,0,1,0,0,0,1
2012,20531,MTL,3,2,1,0,0,6
2012,20531,OTT,1,1,0,0,0,2
2012,20532,PHI,1,0,0,0,0,1
2012,20532,TBL,1,3,1,0,0,5
2012,20533,FLA,1,3,1,0,0,5
2012,20533,TOR,0,2,1,0,0,3
2012,20534,DET,0,1,2,0,0,3
2012,20534,STL,1,1,0,0,0,2
2012,20535,COL,0,0,1,0,0,1
2012,20535,WPG,1,2,1,0,0,4
2012,20536,BUF,0,1,0,0,0,1
2012,20536,NJD,1,2,0,0,0,3
2012,20537,NYR,1,0,0,0,0,1
2012,20537,WSH,1,2,1,0,0,4
2012,20538,MIN,0,0,1,0,0,1
2012,20538,NSH,0,0,1,0,1,2
2012,20539,CHI,0,0,0,0,0,0
2012,20539,LAK,0,1,1,0,0,2
2012,20540,BOS,1,0,0,1,0,2
2012,20540,PHX,1,0,0,0,0,1
2012,20541,SJS,0,2,0,0,0,2
2012,20541,VAN,1,1,0,1,0,3
2012,20542,CGY,1,0,0,0,0,1
2012,20542,NYI,0,1,2,0,0,3
2012,20543,PHI,1,2,1,0,0,4
2012,20543,PIT,1,0,1,0,0,2
2012,20544,CAR,1,0,2,1,0,4
2012,20544,TOR,0,1,2,0,0,3
2012,20545,MTL,1,2,0,0,0,3
2012,20545,TBL,1,1,2,0,0,4
2012,20546,EDM,1,1,1,0,0,3
2012,20546,MIN,1,3,0,0,0,4
2012,20547,LAK,0,0,0,0,0,0
2012,20547,WPG,0,0,0,1,0,1
2012,20548,CBJ,1,1,2,0,0,4
2012,20548,DAL,1,0,0,0,0,1
2012,20549,COL,2,0,1,0,0,3
2012,20549,PHX,1,1,0,0,0,2
2012,20550,ANA,0,0,2,0,0,2
2012,20550,VAN,2,2,1,0,0,5
2012,20551,BUF,0,1,0,0,0,1
2012,20551,WSH,1,1,1,0,0,3
2012,20552,CGY,3,0,0,0,0,3
2012,20552,OTT,0,2,1,1,0,4
2012,20553,FLA,0,1,0,0,0,1
2012,20553,NYR,3,1,0,0,0,4
2012,20554,NSH,1,0,0,0,1,2
2012,20554,STL,1,0,0,0,0,1
2012,20555,CHI,1,1,1,0,0,3
2012,20555,DET,1,1,0,0,0,2
2012,20556,NJD,2,0,1,0,0,3
2012,20556,PIT,0,0,1,0,0,1
2012,20557,EDM,1,0,0,0,0,1
2012,20557,NYI,2,2,0,0,0,4
2012,20558,CAR,1,1,0,0,0,2
2012,20558,TBL,1,1,3,0,0,5
2012,20559,FLA,0,1,2,0,0,3
2012,20559,MTL,1,0,1,0,0,2
2012,20560,MIN,0,1,1,0,0,2
2012,20560,PHX,0,1,3,0,0,4
2012,20561,BUF,1,1,0,0,0,2
2012,20561,OTT,0,2,0,0,1,3
2012,20562,TOR,1,1,0,0,0,2
2012,20562,WPG,0,3,0,0,0,3
2012,20563,DET,0,3,0,0,0,3
2012,20563,STL,0,0,0,0,0,0
2012,20564,CBJ,0,2,0,0,0,2
2012,20564,WSH,0,0,4,0,0,4
2012,20565,BOS,1,0,1,0,0,2
2012,20565,DAL,3,1,0,0,0,4
2012,20566,ANA,0,1,1,0,0,2
2012,20566,COL,1,2,1,0,0,4
2012,20567,LAK,1,2,1,0,0,4
2012,20567,VAN,1,0,0,0,0,1
2012,20568,CGY,1,0,2,0,0,3
2012,20568,NSH,2,2,1,0,0,5
2012,20569,NYR,0,1,2,0,0,3
2012,20569,PHI,0,2,0,0,0,2
2012,20570,NJD,0,2,0,0,0,2
2012,20570,OTT,0,0,2,1,0,3
2012,20571,CHI,1,1,1,0,0,3
2012,20571,EDM,0,3,1,0,0,4
2012,20572,SJS,0,2,0,0,1,3
2012,20572,VAN,1,0,1,0,0,2
2012,20573,COL,0,0,1,0,1,2
2012,20573,LAK,0,1,0,0,0,1
2012,20574,BUF,1,1,2,0,0,4
2012,20574,EDM,1,1,1,0,0,3
2012,20575,TBL,1,2,0,0,0,3
2012,20575,TOR,2,3,2,0,0,7
2012,20576,CGY,0,1,0,0,0,1
2012,20576,WSH,1,2,0,0,0,3
2012,20577,CAR,1,1,1,0,0,3
2012,20577,NYI,1,0,2,0,1,4
2012,20578,PHX,1,0,0,0,0,1
2012,20578,STL,2,1,1,0,0,4
2012,20579,DAL,1,2,1,0,0,4
2012,20579,DET,3,2,0,0,0,5
2012,20580,MTL,2,1,4,0,0,7
2012,20580,WPG,1,1,1,0,0,3
2012,20581,BOS,2,1,3,0,0,6
2012,20581,NJD,1,0,0,0,0,1
2012,20582,MIN,0,0,0,0,0,0
2012,20582,VAN,2,0,1,0,0,3
2012,20583,ANA,1,0,0,0,0,1
2012,20583,SJS,0,2,1,0,0,3
2012,20584,BOS,3,4,2,0,0,9
2012,20584,CGY,0,0,0,0,0,0
2012,20585,TOR,1,1,2,0,0,4
2012,20585,WPG,0,0,0,0,0,0
2012,20586,FLA,1,0,1,0,0,2
2012,20586,NYR,1,0,1,1,0,3
2012,20587,CHI,1,1,2,0,0,4
2012,20587,PHI,1,3,1,0,0,5
2012,20588,OTT,1,1,2,0,0,4
2012,20588,TBL,0,0,1,0,0,1
2012,20589,EDM,0,3,0,0,0,3
2012,20589,STL,1,0,3,0,0,4
2012,20590,DAL,2,1,1,0,0,4
2012,20590,NSH,1,0,0,0,0,1
2012,20591,LAK,0,0,0,1,0,1
2012,20591,PHX,0,0,0,0,0,0
2012,20592,CBJ,1,0,0,0,0,1
2012,20592,SJS,1,1,0,0,0,2
2012,20593,FLA,1,1,0,0,0,2
2012,20593,NJD,1,1,3,0,0,5
2012,20594,NYR,1,1,1,0,0,3
2012,20594,PIT,1,0,0,0,0,1
2012,20595,BUF,0,1,1,0,0,2
2012,20595,CAR,0,1,3,0,0,4
2012,20596,CHI,0,0,0,0,0,0
2012,20596,COL,1,2,1,0,0,4
2012,20597,ANA,0,1,3,0,0,4
2012,20597,NYI,0,1,1,0,0,2
2012,20598,BOS,1,1,1,0,0,3
2012,20598,VAN,1,2,1,0,0,4
2012,20599,OTT,0,1,1,0,0,2
2012,20599,PHI,1,0,1,1,0,3
2012,20600,DAL,0,1,3,0,0,4
2012,20600,EDM,1,0,0,0,0,1
2012,20601,CBJ,0,1,0,0,0,1
2012,20601,LAK,0,0,0,0,0,0
2012,20602,BUF,0,1,0,0,0,1
2012,20602,WPG,0,1,0,1,0,2
2012,20603,DET,0,2,1,0,0,3
2012,20603,TOR,3,0,1,0,0,4
2012,20604,MTL,0,2,1,0,0,3
2012,20604,TBL,1,0,0,0,0,1
2012,20605,NJD,0,2,1,0,0,3
2012,20605,PIT,1,0,0,0,0,1
2012,20606,COL,0,0,0,0,0,0
2012,20606,STL,2,2,0,0,0,4
2012,20607,CAR,0,0,2,0,0,2
2012,20607,NSH,2,1,2,0,0,5
2012,20608,NYI,1,0,0,0,0,1
2012,20608,PHX,1,3,1,0,0,5
2012,20609,CGY,0,0,3,0,0,3
2012,20609,MIN,0,0,1,0,0,1
2012,20610,SJS,0,2,3,0,0,5
2012,20610,WSH,0,1,1,0,0,2
2012,20611,OTT,2,0,4,0,0,6
2012,20611,PHI,3,1,0,0,0,4
2012,20612,CHI,2,0,0,0,0,2
2012,20612,DET,1,0,1,1,0,3
2012,20613,ANA,4,1,2,0,0,7
2012,20613,CBJ,1,1,2,0,0,4
2012,20614,FLA,0,2,0,0,0,2
2012,20614,VAN,1,0,0,0,0,1
2012,20615,LAK,2,2,1,0,0,5
2012,20615,WSH,1,0,1,0,0,2
2012,20616,BOS,1,1,3,0,0,5
2012,20616,WPG,1,2,0,0,0,3
2012,20617,BUF,0,0,0,0,0,0
2012,20617,TOR,2,0,0,0,0,2
2012,20618,DET,0,0,1,0,0,1
2012,20618,NYI,1,3,1,0,0,5
2012,20619,NYR,0,0,1,0,1,2
2012,20619,PHX,0,0,1,0,0,1
2012,20620,OTT,2,2,1,0,0,5
2012,20620,PIT,0,1,0,0,0,1
2012,20621,CAR,0,1,0,0,0,1
2012,20621,PHI,0,1,1,0,0,2
2012,20622,MTL,0,0,0,0,0,0
2012,20622,STL,0,2,1,0,0,3
2012,20623,TBL,0,2,2,0,0,4
2012,20623,VAN,2,2,0,0,1,5
2012,20624,MIN,1,1,2,0,1,5
2012,20624,SJS,1,0,3,0,0,4
2012,20625,CHI,0,2,3,0,0,5
2012,20625,CBJ,0,1,1,0,0,2
2012,20626,COL,0,1,0,0,0,1
2012,20626,NSH,3,0,1,0,0,4
2012,20627,CGY,4,1,1,0,0,6
2012,20627,NJD,0,2,1,0,0,3
2012,20628,ANA,1,1,3,0,0,5
2012,20628,DAL,0,0,2,0,0,2
2012,20629,PIT,0,0,0,0,0,0
2012,20629,WSH,1,0,0,0,0,1
2012,20630,EDM,0,0,1,0,0,1
2012,20630,NJD,0,1,0,1,0,2
2012,20631,BOS,1,0,1,0,0,2
2012,20631,MTL,0,0,1,0,0,1
2012,20632,NYI,0,0,2,0,0,2
2012,20632,PHI,1,1,1,0,0,3
2012,20633,NYR,0,0,0,0,0,0
2012,20633,OTT,0,1,2,0,0,3
2012,20634,CAR,4,0,1,0,0,5
2012,20634,TBL,1,1,0,0,0,2
2012,20635,DET,1,0,1,0,1,3
2012,20635,PHX,1,0,1,0,0,2
2012,20636,STL,1,1,0,0,0,2
2012,20636,VAN,1,1,0,1,0,3
2012,20637,COL,2,0,0,0,0,2
2012,20637,NSH,0,1,1,1,0,3
2012,20638,SJS,0,1,1,0,0,2
2012,20638,WPG,0,0,0,0,0,0
2012,20639,CHI,1,3,1,0,0,5
2012,20639,MIN,1,0,1,0,0,2
2012,20640,ANA,0,0,0,0,0,0
2012,20640,CGY,0,0,0,1,0,1
2012,20641,DAL,2,1,1,0,1,5
2012,20641,LAK,0,2,2,0,0,4
2012,20642,TBL,0,1,2,0,0,3
2012,20642,WSH,2,1,1,0,0,4
2012,20643,CBJ,2,2,0,0,0,4
2012,20643,PHX,1,1,1,0,0,3
2012,20644,BUF,2,1,0,0,0,3
2012,20644,TOR,2,0,0,0,0,2
2012,20645,FLA,0,0,1,0,0,1
2012,20645,PIT,0,2,2,0,0,4
2012,20646,ANA,1,3,1,0,0,5
2012,20646,EDM,0,0,0,0,0,0
2012,20647,CHI,0,1,1,0,0,2
2012,20647,DET,2,0,0,1,0,3
2012,20648,COL,1,0,1,0,0,2
2012,20648,DAL,0,0,1,0,0,1
2012,20649,NYR,0,2,1,0,0,3
2012,20649,TOR,0,0,0,0,0,0
2012,20650,MTL,0,0,2,0,0,2
2012,20650,OTT,0,0,2,0,1,3
2012,20651,BUF,0,2,0,0,0,2
2012,20651,NYI,1,1,2,0,0,4
2012,20652,BOS,0,1,1,0,0,2
2012,20652,CAR,0,1,3,0,0,4
2012,20653,NJD,0,0,2,0,0,2
2012,20653,WPG,1,0,0,0,0,1
2012,20654,CBJ,0,0,1,0,0,1
2012,20654,SJS,0,1,1,0,0,2
2012,20655,MIN,1,1,0,0,0,2
2012,20655,STL,0,2,0,0,1,3
2012,20656,NSH,1,1,2,0,0,4
2012,20656,PHI,0,1,1,0,0,2
2012,20657,CGY,0,1,0,0,0,1
2012,20657,LAK,0,3,1,0,0,4
2012,20658,PIT,2,0,4,0,0,6
2012,20658,TBL,0,0,3,0,0,3
2012,20659,CAR,0,1,0,0,0,1
2012,20659,WSH,0,1,1,0,0,2
2012,20660,MTL,1,3,0,0,0,4
2012,20660,NYR,1,0,0,0,0,1
2012,20661,CHI,2,1,1,0,0,4
2012,20661,SJS,0,2,1,0,0,3
2012,20662,EDM,1,0,0,1,0,2
2012,20662,LAK,0,0,1,0,0,1
2012,20663,ANA,1,2,1,0,0,4
2012,20663,VAN,1,0,1,0,0,2
2012,20664,NSH,3,0,0,0,0,3
2012,20664,NYI,0,0,1,0,0,1
2012,20665,COL,1,0,0,0,0,1
2012,20665,PHX,2,2,2,0,0,6
2012,20666,OTT,0,0,0,0,0,0
2012,20666,WPG,1,1,0,0,0,2
2012,20667,BOS,1,1,0,0,1,3
2012,20667,FLA,0,2,0,0,0,2
2012,20668,BUF,0,0,0,0,0,0
2012,20668,DET,3,2,0,0,0,5
2012,20669,DAL,0,0,0,0,0,0
2012,20669,STL,0,0,1,0,0,1
2012,20670,OTT,1,1,1,0,0,3
2012,20670,TOR,2,0,0,0,0,2
2012,20671,NJD,1,3,1,0,0,5
2012,20671,WPG,0,0,1,0,0,1
2012,20672,NSH,0,0,0,0,0,0
2012,20672,NYR,1,1,1,0,0,3
2012,20673,MIN,0,1,0,0,0,1
2012,20673,PHI,1,3,1,0,0,5
2012,20674,CAR,1,0,0,0,0,1
2012,20674,PIT,1,0,0,0,1,2
2012,20675,NYI,1,1,1,0,0,3
2012,20675,WSH,0,0,0,0,0,0
2012,20676,CBJ,0,2,2,0,0,4
2012,20676,EDM,2,0,0,0,0,2
2012,20677,BOS,0,2,1,0,0,3
2012,20677,TBL,1,1,3,0,0,5
2012,20678,DAL,2,0,0,0,0,2
2012,20678,DET,1,1,0,0,1,3
2012,20679,LAK,1,1,0,0,1,3
2012,20679,VAN,0,1,1,0,0,2
2012,20680,CGY,0,1,0,0,0,1
2012,20680,SJS,0,0,1,0,1,2
2012,20681,MTL,0,0,0,0,0,0
2012,20681,WSH,2,1,0,0,0,3
2012,20682,BUF,1,1,0,0,0,2
2012,20682,CHI,2,2,2,0,0,6
2012,20683,COL,0,1,2,1,0,4
2012,20683,FLA,1,1,1,0,0,3
2012,20684,ANA,2,2,2,0,0,6
2012,20684,PHX,1,1,0,0,0,2
2012,20685,MIN,0,0,1,0,0,1
2012,20685,TOR,2,1,1,0,0,4
2012,20686,BOS,0,0,4,0,0,4
2012,20686,NJD,1,0,0,0,0,1
2012,20687,NYR,0,1,0,0,0,1
2012,20687,PIT,1,0,3,0,0,4
2012,20688,NYI,0,2,2,0,0,4
2012,20688,PHI,0,0,1,0,0,1
2012,20689,CBJ,0,0,0,0,0,0
2012,20689,NSH,0,2,1,0,0,3
2012,20690,EDM,0,0,0,0,0,0
2012,20690,STL,0,0,1,0,0,1
2012,20691,BUF,0,1,0,0,0,1
2012,20691,WPG,1,1,2,0,0,4
2012,20692,DET,0,2,0,0,1,3
2012,20692,PHX,1,1,0,0,0,2
2012,20693,CGY,0,1,0,0,1,2
2012,20693,LAK,1,0,0,0,0,1
2012,20694,OTT,1,2,1,0,0,4
2012,20694,SJS,1,0,0,0,0,1
2012,20695,MTL,2,2,0,0,0,4
2012,20695,PIT,1,1,2,0,1,5
2012,20696,CAR,1,1,1,0,0,3
2012,20696,WSH,0,0,0,0,0,0
2012,20697,CHI,2,1,0,0,0,3
2012,20697,FLA,0,0,1,0,0,1
2012,20698,DAL,0,0,1,0,0,1
2012,20698,TBL,1,0,1,0,0,2
2012,20699,BOS,0,2,0,0,0,2
2012,20699,NYR,0,2,0,1,0,3
2012,20700,NJD,0,1,0,0,0,1
2012,20700,PHI,0,2,2,0,0,4
2012,20701,SJS,1,1,1,0,0,3
2012,20701,VAN,1,1,2,0,0,4
2012,20702,MTL,1,0,2,0,0,3
2012,20702,TOR,1,0,0,0,0,1
2012,20703,CAR,1,0,0,0,0,1
2012,20703,NYI,0,1,0,1,0,2
2012,20704,CBJ,1,1,0,0,0,2
2012,20704,DET,1,1,0,0,1,3
2012,20705,ANA,0,2,0,0,0,2
2012,20705,OTT,0,0,1,0,0,1
2012,20706,FLA,2,0,1,0,1,4
2012,20706,WPG,0,1,2,0,0,3
2012,20707,BUF,1,0,1,0,0,2
2012,20707,STL,0,2,2,0,0,4
2012,20708,CHI,1,0,1,0,0,2
2012,20708,NSH,1,3,1,0,0,5
2012,20709,PHX,0,1,2,0,0,3
2012,20709,TBL,2,2,0,0,0,4
2012,20710,DAL,1,1,0,0,0,2
2012,20710,MIN,0,4,1,0,0,5
2012,20711,CGY,3,1,2,0,0,6
2012,20711,EDM,0,0,2,0,0,2
2012,20712,COL,0,2,1,0,0,3
2012,20712,LAK,0,1,0,0,0,1
2012,20713,BOS,3,0,2,0,1,6
2012,20713,PHI,1,3,1,0,0,5
2012,20714,PIT,2,0,1,1,0,4
2012,20714,WSH,0,2,1,0,0,3
2012,20715,ANA,1,0,2,0,0,3
2012,20715,COL,0,0,2,0,0,2
2012,20716,NYI,0,0,0,0,0,0
2012,20716,TOR,1,0,2,0,0,3
2012,20717,CAR,2,0,0,0,0,2
2012,20717,WPG,0,1,0,0,0,1
2012,20718,DET,0,2,1,0,0,3
2012,20718,STL,1,0,0,0,0,1
2012,20719,CBJ,0,1,0,0,0,1
2012,20719,NSH,1,1,2,0,0,4
2012,20720,EDM,0,1,0,0,1,2
2012,20720,SJS,0,0,1,0,0,1
2012,20721,LAK,1,3,0,0,0,4
2012,20721,OTT,0,0,1,0,0,1
2012,20722,BUF,1,0,0,0,1,2
2012,20722,NJD,0,1,0,0,0,1
2012,20723,NYI,1,1,1,0,0,3
2012,20723,TOR,0,1,2,1,0,4
2012,20724,NYR,1,1,1,0,0,3
2012,20724,WPG,0,0,0,0,0,0
2012,20725,BOS,1,2,0,0,0,3
2012,20725,WSH,0,3,2,0,0,5
2012,20726,CBJ,1,0,1,0,0,2
2012,20726,TBL,1,2,1,0,0,4
2012,20727,FLA,1,1,0,0,0,2
2012,20727,PHI,2,0,0,0,1,3
2012,20728,PIT,0,2,0,0,1,3
2012,20728,STL,0,1,1,0,0,2
2012,20729,CHI,0,0,1,0,0,1
2012,20729,NSH,2,0,1,0,0,3
2012,20730,ANA,0,0,0,0,0,0
2012,20730,DAL,1,0,0,0,0,1
2012,20731,COL,1,1,0,0,0,2
2012,20731,MIN,2,0,1,0,0,3
2012,20732,CGY,0,0,0,0,0,0
2012,20732,SJS,0,0,1,0,0,1
2012,20733,OTT,0,1,1,0,0,2
2012,20733,PHX,1,1,1,0,0,3
2012,20734,EDM,0,1,1,0,0,2
2012,20734,VAN,1,0,1,0,1,3
2012,20735,DET,0,0,2,0,0,2
2012,20735,MTL,4,2,1,0,0,7
2012,20736,BOS,1,1,2,0,0,4
2012,20736,OTT,1,2,0,0,0,3
2012,20737,NJD,0,1,2,0,1,4
2012,20737,NYR,1,0,2,0,0,3
2012,20738,PHI,1,0,0,0,0,1
2012,20738,WPG,0,1,0,0,1,2
2012,20739,PIT,0,1,3,0,1,5
2012,20739,TOR,0,2,2,0,0,4
2012,20740,CAR,0,0,2,0,0,2
2012,20740,NYI,1,1,3,0,0,5
2012,20741,BUF,0,1,2,0,0,3
2012,20741,MTL,1,0,0,0,0,1
2012,20742,TBL,1,2,0,1,0,4
2012,20742,WSH,1,1,1,0,0,3
2012,20743,MIN,2,1,1,0,0,4
2012,20743,NSH,0,1,4,0,0,5
2012,20744,CGY,0,1,0,0,0,1
2012,20744,DET,1,0,2,0,0,3
2012,20745,ANA,0,3,1,0,0,4
2012,20745,PHX,1,0,0,0,0,1
2012,20746,COL,0,1,1,0,0,2
2012,20746,EDM,2,0,1,0,0,3
2012,20747,CHI,1,0,1,0,0,2
2012,20747,VAN,1,0,1,1,0,3
2012,20748,CBJ,0,0,0,0,0,0
2012,20748,SJS,2,2,2,0,0,6
2012,20749,BUF,0,0,0,0,0,0
2012,20749,NYR,0,0,0,0,1,1
2012,20750,PIT,0,0,0,0,0,0
2012,20750,TOR,0,0,1,0,0,1
2012,20751,FLA,0,1,3,0,0,4
2012,20751,WSH,0,1,1,0,0,2
2012,20752,ANA,1,1,0,0,0,2
2012,20752,DAL,3,1,2,0,0,6
2012,20753,CBJ,0,1,1,0,0,2
2012,20753,LAK,1,1,1,0,0,3
2012,20754,BOS,0,0,0,0,0,0
2012,20754,CAR,1,1,1,0,0,3
2012,20755,MTL,2,1,0,0,0,3
2012,20755,NJD,1,1,3,0,0,5
2012,20756,NSH,0,0,1,0,0,1
2012,20756,PHI,1,1,2,0,0,4
2012,20757,TBL,0,0,1,0,0,1
2012,20757,WPG,0,1,0,1,0,2
2012,20758,COL,0,0,0,0,0,0
2012,20758,MIN,1,0,0,0,0,1
2012,20759,CHI,1,2,1,0,0,4
2012,20759,EDM,0,3,5,0,0,8
2012,20760,DET,1,1,1,0,1,4
2012,20760,VAN,1,0,2,0,0,3
2012,20761,DAL,0,1,1,0,0,2
2012,20761,SJS,2,2,1,0,0,5
2012,20762,NYI,0,0,1,1,0,2
2012,20762,OTT,0,1,0,0,0,1
2012,20763,FLA,1,1,0,0,0,2
2012,20763,WPG,0,1,0,0,0,1
2012,20764,LAK,0,0,0,0,0,0
2012,20764,STL,0,1,0,0,0,1
2012,20765,CGY,1,1,1,0,0,3
2012,20765,CHI,1,0,0,0,0,1
2012,20766,ANA,1,1,0,0,0,2
2012,20766,CBJ,0,1,1,1,0,3
2012,20767,BOS,0,0,1,0,0,1
2012,20767,PIT,1,0,1,0,0,2
2012,20768,NJD,3,3,0,0,0,6
2012,20768,PHI,0,0,4,0,0,4
2012,20769,MTL,0,0,0,0,0,0
2012,20769,WSH,1,0,2,0,0,3
2012,20770,COL,1,1,0,0,0,2
2012,20770,VAN,1,0,1,0,1,3
2012,20771,OTT,0,0,0,0,0,0
2012,20771,TOR,2,1,2,0,0,5
2012,20772,BUF,1,1,1,0,1,4
2012,20772,NYI,3,0,0,0,0,3
2012,20773,CAR,0,1,1,0,0,2
2012,20773,LAK,1,0,0,0,0,1
2012,20774,FLA,1,2,0,0,0,3
2012,20774,TBL,1,4,1,0,0,6
2012,20775,NSH,2,0,1,0,0,3
2012,20775,STL,0,0,1,0,0,1
2012,20776,DAL,0,1,0,0,1,2
2012,20776,MIN,0,0,1,0,0,1
2012,20777,PHX,0,3,2,0,0,5
2012,20777,SJS,0,2,1,0,0,3
2012,20778,DET,1,0,3,0,0,4
2012,20778,EDM,3,0,1,0,1,5
2012,20779,BOS,2,0,2,0,0,4
2012,20779,WSH,0,0,1,0,0,1
2012,20780,NJD,2,2,1,0,0,5
2012,20780,PIT,0,1,1,0,0,2
2012,20781,NYR,1,1,3,0,0,5
2012,20781,PHI,0,1,1,0,0,2
2012,20782,MTL,1,2,0,0,0,3
2012,20782,WPG,0,0,0,0,0,0
2012,20783,EDM,2,1,0,0,0,3
2012,20783,TOR,2,3,1,0,0,6
2012,20784,DET,0,1,0,0,0,1
2012,20784,PHX,1,1,1,0,0,3
2012,20785,ANA,2,0,0,0,1,3
2012,20785,CGY,0,1,1,0,0,2
2012,20786,NJD,1,0,0,0,0,1
2012,20786,NYR,0,0,0,0,0,0
2012,20787,NYI,0,0,0,0,1,1
2012,20787,PHI,0,0,0,0,0,0
2012,20788,FLA,0,0,0,0,0,0
2012,20788,WSH,2,2,0,0,0,4
2012,20789,CBJ,1,1,1,0,0,3
2012,20789,MIN,1,0,0,0,0,1
2012,20790,MTL,0,1,1,0,1,3
2012,20790,PIT,0,0,2,0,0,2
2012,20791,OTT,0,1,0,0,0,1
2012,20791,STL,2,1,0,0,0,3
2012,20792,LAK,1,2,0,0,0,3
2012,20792,TBL,0,1,0,0,0,1
2012,20793,NSH,1,2,0,0,0,3
2012,20793,VAN,3,0,0,0,1,4
2012,20794,TOR,1,0,0,0,0,1
2012,20794,WPG,1,1,0,0,0,2
2012,20795,DAL,0,1,0,0,0,1
2012,20795,PHX,1,1,2,0,0,4
2012,20796,CHI,0,2,0,0,0,2
2012,20796,COL,0,2,3,0,0,5
2012,20797,BOS,0,0,0,0,0,0
2012,20797,BUF,2,2,2,0,0,6
2012,20798,DET,1,1,2,0,0,4
2012,20798,EDM,0,1,1,0,0,2
2012,20799,ANA,0,1,1,1,0,3
2012,20799,CAR,1,0,1,0,0,2
2012,20800,CGY,1,2,1,0,0,4
2012,20800,SJS,0,2,1,0,0,3
2012,20801,NJD,1,2,0,0,0,3
2012,20801,STL,1,1,1,0,1,4
2012,20802,MTL,1,1,2,0,0,4
2012,20802,NYI,0,0,2,0,0,2
2012,20803,NYR,0,2,1,1,0,4
2012,20803,TBL,1,2,0,0,0,3
2012,20804,PHI,1,3,0,0,0,4
2012,20804,TOR,0,3,0,0,0,3
2012,20805,WSH,0,0,2,0,0,2
2012,20805,WPG,0,0,2,0,1,3
2012,20806,CBJ,0,2,0,0,0,2
2012,20806,DAL,2,1,1,0,0,4
2012,20807,NSH,1,1,1,0,0,3
2012,20807,OTT,1,2,1,0,0,4
2012,20808,FLA,0,2,1,0,0,3
2012,20808,LAK,0,0,1,0,0,1
2012,20809,MIN,1,0,1,0,0,2
2012,20809,VAN,2,1,2,0,0,5
2012,20810,CGY,0,0,1,0,0,1
2012,20810,PHX,1,0,0,1,0,2
2012,20811,PIT,2,3,3,0,0,8
2012,20811,WPG,2,1,2,0,0,5
2012,20812,BUF,0,0,2,0,1,3
2012,20812,DAL,1,0,1,0,0,2
2012,20813,ANA,1,0,0,0,0,1
2012,20813,DET,1,0,0,0,1,2
2012,20814,CAR,2,1,0,0,0,3
2012,20814,COL,1,2,0,1,0,4
2012,20815,CHI,0,2,1,0,0,3
2012,20815,SJS,2,1,2,0,0,5
2012,20816,BOS,1,0,2,0,1,4
2012,20816,NSH,0,1,2,0,0,3
2012,20817,FLA,1,1,1,0,0,3
2012,20817,NJD,1,0,0,0,0,1
2012,20818,LAK,0,1,0,0,0,1
2012,20818,NYI,1,0,0,1,0,2
2012,20819,NYR,2,1,2,0,0,5
2012,20819,PHI,1,1,0,0,0,2
2012,20820,EDM,0,2,1,1,0,4
2012,20820,OTT,1,1,1,0,0,3
2012,20821,BUF,0,0,1,0,0,1
2012,20821,TBL,0,2,0,0,0,2
2012,20822,MTL,0,4,1,0,0,5
2012,20822,TOR,0,0,0,0,0,0
2012,20823,COL,2,0,0,0,0,2
2012,20823,STL,2,0,0,1,0,3
2012,20824,CBJ,1,1,1,0,0,3
2012,20824,MIN,1,0,0,0,0,1
2012,20825,CHI,0,0,0,0,0,0
2012,20825,PHX,2,1,0,0,0,3
2012,20826,CGY,1,1,0,0,1,3
2012,20826,VAN,0,1,1,0,0,2
2012,20827,FLA,1,3,0,0,0,4
2012,20827,NYI,1,0,0,0,0,1
2012,20828,NYR,1,1,1,0,0,3
2012,20828,WSH,0,1,1,0,0,2
2012,20829,DET,1,2,1,0,0,4
2012,20829,PHI,1,2,0,0,0,3
2012,20830,ANA,2,3,0,0,0,5
2012,20830,CBJ,1,1,1,0,0,3
2012,20831,DAL,0,1,1,0,0,2
2012,20831,LAK,1,1,2,0,0,4
2012,20832,PIT,1,3,0,0,0,4
2012,20832,TBL,2,0,0,0,0,2
2012,20833,SJS,0,0,0,0,0,0
2012,20833,STL,1,1,1,0,0,3
2012,20834,SJS,1,2,2,0,0,5
2012,20834,WSH,0,1,2,0,0,3
2012,20835,CAR,1,1,3,0,0,5
2012,20835,MTL,0,3,0,0,0,3
2012,20836,PHX,0,0,1,0,0,1
2012,20836,VAN,0,1,0,0,1,2
2012,20837,BOS,0,0,0,0,0,0
2012,20837,NYR,2,0,1,0,0,3
2012,20838,BUF,0,1,0,0,0,1
2012,20838,NJD,1,0,3,0,0,4
2012,20839,CBJ,1,0,1,0,0,2
2012,20839,STL,1,0,0,0,0,1
2012,20840,OTT,1,1,2,0,0,4
2012,20840,TBL,0,0,0,0,0,0
2012,20841,DAL,0,0,1,0,0,1
2012,20841,DET,2,0,1,0,0,3
2012,20842,CHI,1,0,1,0,0,2
2012,20842,NSH,1,1,1,0,0,3
2012,20843,ANA,0,0,2,0,0,2
2012,20843,MIN,1,0,0,0,0,1
2012,20844,NYI,0,1,2,0,0,3
2012,20844,WPG,1,0,0,0,0,1
2012,20845,CGY,2,1,2,0,0,5
2012,20845,TOR,1,0,0,0,0,1
2012,20846,ANA,0,1,1,0,0,2
2012,20846,PIT,1,0,0,0,0,1
2012,20847,BOS,1,2,0,0,1,4
2012,20847,MTL,0,1,2,0,0,3
2012,20848,FLA,1,0,1,0,0,2
2012,20848,OTT,1,3,2,0,0,6
2012,20849,EDM,1,1,1,0,0,3
2012,20849,TOR,2,0,1,1,0,4
2012,20850,COL,0,1,0,0,0,1
2012,20850,VAN,1,0,2,0,0,3
2012,20851,CHI,4,0,0,0,0,4
2012,20851,NYR,0,1,1,0,0,2
2012,20852,BUF,2,0,0,0,0,2
2012,20852,PHI,0,4,3,0,0,7
2012,20853,SJS,1,3,1,0,0,5
2012,20853,TBL,2,1,2,1,0,6
2012,20854,NYI,1,0,0,0,0,1
2012,20854,STL,2,3,0,0,0,5
2012,20855,MIN,1,1,1,0,0,3
2012,20855,WPG,1,1,1,0,1,4
2012,20856,CGY,1,0,1,0,0,2
2012,20856,DAL,1,1,0,1,0,3
2012,20857,LAK,0,0,0,0,0,0
2012,20857,PHX,0,1,0,0,0,1
2012,20858,ANA,0,1,1,0,0,2
2012,20858,NJD,0,2,0,0,1,3
2012,20859,CAR,2,0,1,0,0,3
2012,20859,SJS,0,0,2,0,0,2
2012,20860,BUF,2,0,1,0,0,3
2012,20860,MTL,2,1,0,0,1,4
2012,20861,FLA,1,0,0,0,0,1
2012,20861,WSH,0,0,2,0,0,2
2012,20862,DET,1,0,1,0,0,2
2012,20862,NSH,0,1,0,0,0,1
2012,20863,BOS,0,1,1,0,0,2
2012,20863,WPG,0,2,2,0,0,4
2012,20864,COL,1,2,0,0,0,3
2012,20864,EDM,0,1,0,0,0,1
2012,20865,PHI,2,1,1,0,0,4
2012,20865,PIT,1,2,3,0,0,6
2012,20866,CHI,2,2,2,0,0,6
2012,20866,CBJ,1,0,0,0,0,1
2012,20867,MIN,0,0,0,0,0,0
2012,20867,STL,1,2,1,0,0,4
2012,20868,CAR,1,2,0,0,0,3
2012,20868,NYI,1,2,1,0,0,4
2012,20869,TBL,1,1,0,0,0,2
2012,20869,WSH,0,1,0,0,0,1
2012,20870,TOR,0,1,1,0,0,2
2012,20870,VAN,2,3,1,0,0,6
2012,20871,DAL,0,1,0,0,0,1
2012,20871,PHX,1,0,0,1,0,2
2012,20872,CGY,0,0,1,0,0,1
2012,20872,LAK,0,0,0,0,0,0
2012,20873,BUF,2,1,3,0,0,6
2012,20873,PIT,0,1,1,0,0,2
2012,20874,DET,1,1,1,0,0,3
2012,20874,SJS,0,1,1,0,0,2
2012,20875,CHI,0,0,3,0,0,3
2012,20875,STL,1,0,0,0,0,1
2012,20876,BOS,0,0,0,0,0,0
2012,20876,MIN,0,2,0,0,0,2
2012,20877,MTL,0,0,1,0,0,1
2012,20877,NJD,1,1,1,0,0,3
2012,20878,ANA,1,0,1,0,0,2
2012,20878,FLA,0,0,0,0,0,0
2012,20879,CBJ,0,1,1,0,0,2
2012,20879,NYR,1,1,0,1,0,3
2012,20880,DAL,1,0,1,0,0,2
2012,20880,NSH,2,1,0,0,0,3
2012,20881,EDM,0,2,0,0,0,2
2012,20881,VAN,2,2,1,0,0,5
2012,20882,COL,0,1,0,0,0,1
2012,20882,WPG,0,3,2,0,0,5
2012,20883,NYI,0,0,0,0,0,0
2012,20883,OTT,3,1,2,0,0,6
2012,20884,CAR,3,1,1,0,0,5
2012,20884,WSH,0,0,0,0,0,0
2012,20885,BUF,1,1,0,0,0,2
2012,20885,NYI,0,0,1,0,0,1
2012,20886,NJD,2,1,0,1,0,4
2012,20886,TOR,1,1,1,0,0,3
2012,20887,NYR,0,0,0,0,0,0
2012,20887,PIT,0,2,0,0,0,2
2012,20888,CBJ,4,1,1,0,0,6
2012,20888,SJS,0,2,1,0,0,3
2012,20889,DAL,1,0,2,0,0,3
2012,20889,MTL,0,0,0,0,0,0
2012,20890,ANA,0,2,0,0,0,2
2012,20890,TBL,2,1,0,0,0,3
2012,20891,NSH,0,2,1,0,0,3
2012,20891,VAN,0,1,0,0,0,1
2012,20892,PHI,1,2,1,1,0,5
2012,20892,WPG,1,2,1,0,0,4
2012,20893,CHI,0,1,1,0,0,2
2012,20893,DET,1,0,0,0,0,1
2012,20894,CGY,1,0,0,0,0,1
2012,20894,EDM,1,4,1,0,0,6
2012,20895,LAK,3,1,0,0,0,4
2012,20895,PHX,0,3,1,0,1,5
2012,20896,OTT,2,2,1,0,0,5
2012,20896,WSH,0,0,2,0,0,2
2012,20897,BOS,3,0,1,0,0,4
2012,20897,STL,2,0,0,0,0,2
2012,20898,COL,3,1,0,0,0,4
2012,20898,LAK,0,0,1,0,0,1
2012,20899,SJS,0,2,0,0,0,2
2012,20899,TOR,0,0,1,0,0,1
2012,20900,ANA,1,0,1,0,1,3
2012,20900,CAR,1,1,0,0,0,2
2012,20901,FLA,0,1,1,0,0,2
2012,20901,MIN,0,1,1,0,1,3
2012,20902,DET,1,0,2,0,0,3
2012,20902,VAN,0,1,2,0,1,4
2012,20903,NSH,0,2,0,0,0,2
2012,20903,STL,1,1,0,0,1,3
2012,20904,TBL,0,0,3,0,0,3
2012,20904,WPG,2,2,0,0,0,4
2012,20905,CHI,0,1,0,0,0,1
2012,20905,DAL,0,0,3,0,0,3
2012,20906,CGY,2,0,1,0,0,3
2012,20906,PHX,0,2,1,0,1,4
2012,20907,EDM,0,2,0,0,0,2
2012,20907,PHI,0,0,0,0,0,0
2012,20908,NJD,0,1,0,0,0,1
2012,20908,VAN,1,1,0,0,0,2
2012,20909,NYI,2,1,0,0,1,4
2012,20909,NYR,1,2,0,0,0,3
2012,20910,MTL,0,0,1,0,0,1
2012,20910,WSH,1,2,1,0,0,4
2012,20911,COL,1,1,3,0,0,5
2012,20911,CBJ,0,0,0,0,0,0
2012,20912,BOS,0,0,1,0,0,1
2012,20912,BUF,0,1,0,0,1,2
2012,20913,DAL,2,1,1,0,0,4
2012,20913,MIN,0,0,1,0,0,1
2012,20914,PIT,3,2,3,0,0,8
2012,20914,TBL,0,1,0,0,0,1
2012,20915,STL,2,0,0,0,1,3
2012,20915,WPG,0,2,0,0,0,2
2012,20916,EDM,0,0,1,0,0,1
2012,20916,PHX,2,0,1,0,0,3
2012,20917,CHI,0,0,0,0,0,0
2012,20917,LAK,2,2,0,0,0,4
2012,20918,TOR,0,0,2,0,0,2
2012,20918,WSH,2,2,0,0,0,4
2012,20919,BOS,2,1,2,0,0,5
2012,20919,OTT,1,0,2,0,0,3
2012,20920,BUF,1,0,1,0,0,2
2012,20920,NYR,0,1,1,1,0,3
2012,20921,CAR,1,1,0,0,0,2
2012,20921,FLA,0,0,2,0,1,3
2012,20922,COL,2,1,1,0,0,4
2012,20922,DET,0,0,3,0,0,3
2012,20923,NSH,3,1,2,0,0,6
2012,20923,SJS,1,1,0,0,0,2
2012,20924,CGY,2,1,1,0,0,4
2012,20924,PHI,0,2,2,0,1,5
2012,20925,NJD,1,0,2,0,0,3
2012,20925,TBL,0,2,2,0,0,4
2012,20926,CBJ,0,1,1,0,0,2
2012,20926,PIT,0,1,3,0,0,4
2012,20927,DAL,0,1,1,1,0,3
2012,20927,VAN,0,2,0,0,0,2
2012,20928,NYI,1,0,1,0,0,2
2012,20928,OTT,0,2,3,0,0,5
2012,20929,FLA,1,2,1,0,0,4
2012,20929,MTL,2,0,0,0,0,2
2012,20930,MIN,1,1,2,0,0,4
2012,20930,SJS,2,0,1,0,0,3
2012,20931,ANA,1,1,1,0,0,3
2012,20931,CHI,1,0,0,0,0,1
2012,20932,NJD,0,0,0,0,0,0
2012,20932,NYR,1,0,1,0,0,2
2012,20933,LAK,0,0,1,0,0,1
2012,20933,NSH,1,1,0,0,0,2
2012,20934,EDM,0,1,4,0,0,5
2012,20934,WPG,0,2,1,0,0,3
2012,20935,ANA,0,1,0,0,0,1
2012,20935,COL,1,0,3,0,0,4
2012,20936,CGY,1,0,0,0,0,1
2012,20936,STL,2,1,0,0,0,3
2012,20937,BOS,0,0,0,0,0,0
2012,20937,OTT,1,0,0,0,0,1
2012,20938,FLA,2,1,2,0,0,5
2012,20938,TOR,0,1,2,0,0,3
2012,20939,NYI,1,0,1,0,0,2
2012,20939,WSH,0,0,2,1,0,3
2012,20940,CAR,0,3,1,0,0,4
2012,20940,NSH,1,1,1,0,0,3
2012,20941,CBJ,1,0,1,0,0,2
2012,20941,DET,1,0,4,0,0,5
2012,20942,MTL,1,0,0,0,0,1
2012,20942,TBL,1,1,0,0,0,2
2012,20943,LAK,3,1,0,0,0,4
2012,20943,MIN,0,0,0,0,0,0
2012,20944,PHX,0,0,1,0,0,1
2012,20944,VAN,0,1,0,0,1,2
2012,20945,PHI,0,0,0,0,0,0
2012,20945,SJS,1,0,0,0,0,1
2012,20946,DAL,1,1,1,0,0,3
2012,20946,PIT,1,0,2,0,1,4
2012,20947,CHI,2,2,1,0,0,5
2012,20947,TOR,3,0,1,0,0,4
2012,20948,EDM,0,2,0,0,0,2
2012,20948,STL,1,2,2,0,0,5
2012,20949,ANA,0,0,0,0,0,0
2012,20949,BUF,1,1,0,0,0,2
2012,20950,BOS,2,0,1,1,0,4
2012,20950,NJD,0,3,0,0,0,3
2012,20951,MIN,1,0,3,0,0,4
2012,20951,MTL,2,1,1,0,1,5
2012,20952,NYI,1,1,1,0,0,3
2012,20952,PHI,2,2,2,0,0,6
2012,20953,CAR,0,1,1,0,0,2
2012,20953,NYR,0,2,1,0,0,3
2012,20954,FLA,0,0,0,0,0,0
2012,20954,WPG,2,0,5,0,0,7
2012,20955,COL,0,0,0,0,0,0
2012,20955,CBJ,1,1,0,0,0,2
2012,20956,CGY,3,0,1,0,0,4
2012,20956,PHX,0,2,0,0,0,2
2012,20957,STL,0,0,0,0,0,0
2012,20957,VAN,0,0,2,0,0,2
2012,20958,BUF,1,0,0,0,0,1
2012,20958,SJS,0,0,0,0,0,0
2012,20959,NJD,3,2,0,0,0,5
2012,20959,WSH,0,0,0,0,0,0
2012,20960,CHI,0,2,0,0,0,2
2012,20960,OTT,1,0,0,0,0,1
2012,20961,NYR,1,1,1,0,0,3
2012,20961,TBL,0,1,2,1,0,4
2012,20962,DET,2,3,1,0,0,6
2012,20962,MIN,0,0,0,0,0,0
2012,20963,DAL,0,2,1,0,0,3
2012,20963,EDM,0,0,1,0,0,1
2012,20964,ANA,1,1,1,0,0,3
2012,20964,CGY,1,0,1,0,0,2
2012,20965,BOS,1,0,1,0,0,2
2012,20965,NYI,1,1,1,0,0,3
2012,20966,MTL,1,0,0,0,0,1
2012,20966,TOR,0,1,2,0,0,3
2012,20967,CAR,0,3,0,0,0,3
2012,20967,TBL,1,1,1,1,0,4
2012,20968,FLA,0,1,0,0,0,1
2012,20968,NSH,1,1,1,0,0,3
2012,20969,CBJ,1,1,3,0,0,5
2012,20969,PHX,0,2,0,0,0,2
2012,20970,COL,0,0,1,0,0,1
2012,20970,PIT,2,2,1,0,0,5
2012,20971,BUF,3,0,2,0,0,5
2012,20971,VAN,0,1,2,0,0,3
2012,20972,ANA,1,1,0,0,0,2
2012,20972,LAK,1,2,1,0,0,4
2012,20973,SJS,1,0,0,0,0,1
2012,20973,STL,2,1,0,0,0,3
2012,20974,NJD,0,0,0,0,0,0
2012,20974,NYI,0,1,0,0,0,1
2012,20975,BOS,1,1,1,0,0,3
2012,20975,NYR,2,0,2,0,0,4
2012,20976,CHI,1,1,0,0,0,2
2012,20976,DET,1,0,0,0,0,1
2012,20977,FLA,0,3,1,0,0,4
2012,20977,OTT,2,0,0,0,0,2
2012,20978,CGY,0,1,1,0,0,2
2012,20978,DAL,0,2,0,0,1,3
2012,20979,PHI,0,1,0,0,0,1
2012,20979,WSH,0,0,0,0,0,0
2012,20980,COL,2,0,0,0,0,2
2012,20980,MIN,0,0,0,0,0,0
2012,20981,PHX,0,0,1,0,0,1
2012,20981,PIT,2,0,0,0,0,2
2012,20982,BUF,0,1,0,0,0,1
2012,20982,WPG,1,0,2,0,0,3
2012,20983,ANA,1,0,3,0,0,4
2012,20983,EDM,0,1,1,0,0,2
2012,20984,BOS,1,4,0,0,0,5
2012,20984,TOR,1,2,1,0,0,4
2012,20985,NJD,1,0,3,0,0,4
2012,20985,NYR,0,1,0,0,0,1
2012,20986,DET,1,0,1,0,0,2
2012,20986,PHI,2,1,0,0,0,3
2012,20987,CAR,0,2,1,1,0,4
2012,20987,WSH,1,1,1,0,0,3
2012,20988,CBJ,2,1,0,0,0,3
2012,20988,PHX,1,1,0,0,0,2
2012,20989,OTT,3,1,3,0,0,7
2012,20989,TBL,0,2,1,0,0,3
2012,20990,CHI,0,0,1,0,0,1
2012,20990,STL,2,1,2,0,0,5
2012,20991,LAK,2,1,2,0,0,5
2012,20991,NSH,1,2,1,0,0,4
2012,20992,COL,1,4,2,0,0,7
2012,20992,MIN,0,0,1,0,0,1
2012,20993,CGY,2,2,1,0,0,5
2012,20993,MTL,1,1,2,0,0,4
2012,20994,DAL,0,2,3,0,0,5
2012,20994,VAN,0,1,1,0,0,2
2012,20995,EDM,1,1,0,0,1,3
2012,20995,SJS,1,1,0,0,0,2
2012,20996,BUF,0,2,0,1,0,3
2012,20996,CAR,1,1,0,0,0,2
2012,20997,PIT,0,1,2,0,0,3
2012,20997,TOR,0,2,0,0,0,2
2012,20998,BOS,0,1,2,0,0,3
2012,20998,BUF,1,0,0,0,0,1
2012,20999,NJD,1,1,3,0,0,5
2012,20999,NYI,0,1,0,0,0,1
2012,21000,FLA,0,0,0,0,0,0
2012,21000,PHI,1,2,2,0,0,5
2012,21001,TBL,0,2,0,0,0,2
2012,21001,WSH,1,0,1,1,0,3
2012,21002,CBJ,2,1,0,0,0,3
2012,21002,LAK,1,0,0,0,0,1
2012,21003,NYR,1,0,0,0,0,1
2012,21003,OTT,2,0,2,0,0,4
2012,21004,ANA,0,1,0,0,0,1
2012,21004,STL,0,1,2,0,0,3
2012,21005,COL,1,0,1,0,0,2
2012,21005,NSH,2,1,1,0,0,4
2012,21006,DAL,0,1,2,0,1,4
2012,21006,SJS,0,1,2,0,0,3
2012,21007,MIN,2,0,0,0,1,3
2012,21007,PHX,0,0,2,0,0,2
2012,21008,EDM,1,1,1,0,0,3
2012,21008,MTL,1,1,3,0,0,5
2012,21009,VAN,0,1,2,0,0,3
2012,21009,WPG,0,1,1,0,0,2
2012,21010,FLA,0,1,0,0,0,1
2012,21010,PIT,0,0,1,0,1,2
2012,21011,DET,1,1,2,0,0,4
2012,21011,LAK,2,0,1,0,0,3
2012,21012,CHI,0,1,3,0,0,4
2012,21012,NYR,1,0,2,0,0,3
2012,21013,CGY,3,1,1,0,0,5
2012,21013,WPG,2,0,1,0,0,3
2012,21014,BOS,1,1,1,0,0,3
2012,21014,WSH,2,2,0,0,0,4
2012,21015,COL,0,2,0,0,1,3
2012,21015,EDM,1,0,1,0,0,2
2012,21016,PHI,0,0,0,0,1,1
2012,21016,TOR,0,0,0,0,0,0
2012,21017,BUF,0,2,1,0,1,4
2012,21017,OTT,1,1,1,0,0,3
2012,21018,NJD,0,0,2,0,0,2
2012,21018,NYI,0,0,1,0,0,1
2012,21019,CAR,2,0,2,0,0,4
2012,21019,TBL,2,0,0,0,0,2
2012,21020,CBJ,0,1,0,0,0,1
2012,21020,STL,1,2,1,0,0,4
2012,21021,DET,1,0,1,0,0,2
2012,21021,NSH,2,0,1,0,0,3
2012,21022,ANA,0,0,0,0,0,0
2012,21022,DAL,0,1,1,0,0,2
2012,21023,PHX,0,2,1,0,0,3
2012,21023,SJS,0,0,0,0,0,0
2012,21024,MTL,0,1,3,0,0,4
2012,21024,VAN,0,1,0,0,0,1
2012,21025,TOR,0,0,0,0,0,0
2012,21025,WSH,1,0,1,0,0,2
2012,21026,CAR,0,0,0,0,0,0
2012,21026,FLA,0,1,1,0,0,2
2012,21027,CBJ,0,1,0,0,0,1
2012,21027,STL,0,1,1,0,0,2
2012,21028,CGY,1,0,3,0,0,4
2012,21028,MIN,0,0,3,0,0,3
2012,21029,NJD,1,0,3,0,0,4
2012,21029,PHI,0,0,1,0,0,1
2012,21030,NYI,1,2,0,0,0,3
2012,21030,NYR,1,1,1,1,0,4
2012,21031,CHI,0,1,1,0,0,2
2012,21031,LAK,1,1,0,0,1,3
2012,21032,BOS,0,2,0,0,0,2
2012,21032,PIT,3,1,1,0,0,5
2012,21033,BUF,0,1,1,1,0,3
2012,21033,MTL,1,0,1,0,0,2
2012,21034,ANA,0,1,1,0,0,2
2012,21034,COL,1,0,1,1,0,3
2012,21035,EDM,1,1,0,0,0,2
2012,21035,SJS,1,1,1,0,0,3
2012,21036,NSH,1,2,1,0,1,5
2012,21036,PHX,0,2,2,0,0,4
2012,21037,NYI,2,2,0,0,0,4
2012,21037,WSH,0,2,2,0,1,5
2012,21038,CAR,0,2,0,0,0,2
2012,21038,NYR,1,2,1,0,0,4
2012,21039,NJD,0,0,0,0,0,0
2012,21039,PHI,0,1,2,0,0,3
2012,21040,BOS,0,0,1,0,0,1
2012,21040,TBL,4,1,1,0,0,6
2012,21041,FLA,1,1,3,0,0,5
2012,21041,TOR,0,1,1,0,0,2
2012,21042,DAL,0,0,1,0,0,1
2012,21042,MIN,0,0,0,0,0,0
2012,21043,CHI,1,1,1,0,1,4
2012,21043,STL,3,0,0,0,0,3
2012,21044,CGY,0,2,0,1,0,3
2012,21044,SJS,1,0,1,0,0,2
2012,21045,DET,0,1,1,0,0,2
2012,21045,LAK,2,1,2,0,0,5
2012,21046,BUF,2,1,1,0,0,4
2012,21046,COL,2,1,1,0,1,5
2012,21047,MTL,1,0,1,0,1,3
2012,21047,OTT,1,0,1,0,0,2
2012,21048,DAL,0,1,1,0,0,2
2012,21048,WPG,1,4,0,0,0,5
2012,21049,CBJ,0,0,0,0,0,0
2012,21049,EDM,0,2,1,0,0,3
2012,21050,PHX,2,2,1,0,0,5
2012,21050,VAN,2,1,1,0,0,4
2012,21051,ANA,0,3,1,0,0,4
2012,21051,DET,0,0,0,0,0,0
2012,21052,COL,0,0,0,0,0,0
2012,21052,NJD,0,0,0,0,1,1
2012,21053,NYI,0,0,2,0,0,2
2012,21053,PHI,2,1,0,0,0,3
2012,21054,NYR,1,1,0,0,0,2
2012,21054,PIT,1,2,2,0,0,5
2012,21055,CAR,0,0,2,0,0,2
2012,21055,STL,0,0,0,0,0,0
2012,21056,TBL,0,0,1,0,0,1
2012,21056,TOR,1,2,0,0,0,3
2012,21057,BOS,0,1,1,0,0,2
2012,21057,FLA,1,3,2,0,0,6
2012,21058,CGY,1,2,1,0,0,4
2012,21058,PHX,0,1,0,0,0,1
2012,21059,NSH,1,0,0,0,0,1
2012,21059,SJS,0,0,1,0,1,2
2012,21060,MTL,1,0,0,0,0,1
2012,21060,OTT,0,0,1,1,0,2
2012,21061,WSH,1,0,1,0,0,2
2012,21061,WPG,1,1,1,0,0,3
2012,21062,CHI,2,0,2,0,0,4
2012,21062,DAL,0,0,1,0,0,1
2012,21063,CGY,0,1,0,0,0,1
2012,21063,EDM,2,0,1,0,0,3
2012,21064,ANA,0,1,1,0,0,2
2012,21064,LAK,3,0,1,0,0,4
2012,21065,BOS,2,0,0,0,1,3
2012,21065,PHI,0,1,1,0,0,2
2012,21066,NJD,1,0,1,0,0,2
2012,21066,PIT,1,3,1,0,0,5
2012,21067,CAR,1,1,3,0,0,5
2012,21067,MIN,1,2,0,0,0,3
2012,21068,MTL,1,0,1,0,0,2
2012,21068,NYI,0,2,0,0,1,3
2012,21069,OTT,0,0,1,0,0,1
2012,21069,TOR,0,1,2,0,0,3
2012,21070,COL,1,1,1,0,0,3
2012,21070,NYR,1,0,0,0,0,1
2012,21071,STL,2,1,0,0,0,3
2012,21071,TBL,0,0,1,0,0,1
2012,21072,BUF,1,1,0,0,0,2
2012,21072,FLA,2,0,0,0,1,3
2012,21073,CBJ,1,1,1,0,0,3
2012,21073,VAN,2,1,1,0,0,4
2012,21074,LAK,1,0,3,0,0,4
2012,21074,NSH,0,1,1,0,0,2
2012,21075,DET,1,0,1,0,0,2
2012,21075,SJS,2,0,0,1,0,3
2012,21076,PHI,0,0,2,1,0,3
2012,21076,PIT,1,1,0,0,0,2
2012,21077,CHI,2,2,1,0,0,5
2012,21077,WSH,0,2,0,0,0,2
2012,21078,CGY,0,0,1,0,0,1
2012,21078,CBJ,1,0,0,0,1,2
2012,21079,EDM,0,2,0,0,0,2
2012,21079,PHX,0,0,2,0,1,3
2012,21080,ANA,1,0,0,0,0,1
2012,21080,NSH,0,0,3,0,0,3
2012,21081,CAR,1,1,2,0,0,4
2012,21081,WPG,1,2,0,0,0,3
2012,21082,BOS,4,3,1,0,0,8
2012,21082,TOR,0,0,0,0,0,0
2012,21083,NJD,0,2,0,0,0,2
2012,21083,NYR,1,2,1,0,0,4
2012,21084,BUF,2,4,1,0,0,7
2012,21084,TBL,0,2,1,0,0,3
2012,21085,DET,0,1,2,0,0,3
2012,21085,WSH,3,1,1,0,0,5
2012,21086,MIN,1,0,1,0,0,2
2012,21086,VAN,0,0,0,0,0,0
2012,21087,ANA,2,3,0,0,0,5
2012,21087,SJS,2,1,0,0,0,3
2012,21088,NYI,1,1,3,0,0,5
2012,21088,TOR,1,1,0,0,0,2
2012,21089,FLA,1,1,0,0,0,2
2012,21089,PHI,0,1,0,0,0,1
2012,21090,PIT,2,4,2,0,0,8
2012,21090,WPG,2,2,0,0,0,4
2012,21091,CHI,3,0,2,0,0,5
2012,21091,CBJ,0,0,1,0,0,1
2012,21092,NJD,0,1,0,0,0,1
2012,21092,OTT,0,0,0,0,0,0
2012,21093,EDM,2,3,1,0,0,6
2012,21093,NSH,1,1,1,0,0,3
2012,21094,DAL,1,2,0,0,1,4
2012,21094,PHX,1,0,2,0,0,3
2012,21095,CGY,1,0,0,0,0,1
2012,21095,COL,1,0,0,1,0,2
2012,21096,LAK,1,1,3,0,0,5
2012,21096,SJS,1,0,1,0,0,2
2012,21097,BUF,1,1,1,0,0,3
2012,21097,MTL,0,0,0,0,0,0
2012,21098,CAR,1,1,1,0,0,3
2012,21098,FLA,0,1,0,0,0,1
2012,21099,DET,1,0,0,0,0,1
2012,21099,NYR,1,0,0,1,0,2
2012,21100,CHI,0,1,0,1,0,2
2012,21100,VAN,1,0,0,0,0,1
2012,21101,ANA,1,1,2,0,0,4
2012,21101,STL,2,0,1,0,0,3
2012,21102,PHI,0,1,0,0,1,2
2012,21102,WSH,1,0,0,0,0,1
2012,21103,NSH,0,1,0,0,0,1
2012,21103,PIT,2,2,1,0,0,5
2012,21104,EDM,0,1,1,0,0,2
2012,21104,TBL,0,2,0,0,1,3
2012,21105,CGY,1,1,0,0,0,2
2012,21105,MIN,0,1,1,0,1,3
2012,21106,DAL,0,0,1,0,0,1
2012,21106,VAN,1,0,1,0,0,2
2012,21107,COL,0,0,2,0,0,2
2012,21107,PHX,2,1,0,0,0,3
2012,21108,LAK,0,0,0,0,1,1
2012,21108,STL,0,0,0,0,0,0
2012,21109,BOS,0,0,1,0,0,1
2012,21109,SJS,1,0,1,0,0,2
2012,21110,NJD,0,1,2,0,0,3
2012,21110,TOR,0,2,1,0,1,4
2012,21111,BUF,0,2,2,0,0,4
2012,21111,NYR,0,1,0,0,0,1
2012,21112,WSH,1,2,0,0,0,3
2012,21112,WPG,0,2,1,1,0,4
2012,21113,CAR,0,1,0,0,0,1
2012,21113,CBJ,1,2,2,0,0,5
2012,21114,MTL,4,0,1,0,0,5
2012,21114,OTT,1,0,0,0,0,1
2012,21115,EDM,0,1,0,0,1,2
2012,21115,FLA,0,1,0,0,0,1
2012,21116,CGY,1,0,0,0,0,1
2012,21116,DAL,2,0,2,0,0,4
2012,21117,BOS,0,1,3,0,0,4
2012,21117,LAK,0,1,1,0,0,2
2012,21118,BUF,0,1,2,0,0,3
2012,21118,MIN,1,0,0,0,0,1
2012,21119,NYR,1,1,1,0,1,4
2012,21119,TOR,1,1,1,0,0,3
2012,21120,OTT,1,4,3,0,0,8
2012,21120,PIT,2,1,1,0,0,4
2012,21121,MTL,0,1,0,0,0,1
2012,21121,PHI,1,2,1,0,0,4
2012,21122,NYI,0,2,1,0,0,3
2012,21122,TBL,1,1,2,0,0,4
2012,21123,CAR,1,3,0,0,0,4
2012,21123,DET,0,3,2,0,0,5
2012,21124,NSH,0,2,1,0,0,3
2012,21124,WPG,0,0,1,0,0,1
2012,21125,COL,1,1,0,0,0,2
2012,21125,VAN,0,2,0,1,0,3
2012,21126,PHX,2,1,0,0,0,3
2012,21126,SJS,2,1,0,0,1,4
2012,21127,CBJ,1,1,1,0,0,3
2012,21127,EDM,0,5,1,0,0,6
2012,21128,MIN,0,0,0,0,0,0
2012,21128,WSH,0,2,1,0,0,3
2012,21129,FLA,1,0,1,0,0,2
2012,21129,NYI,0,1,1,0,1,3
2012,21130,NJD,1,0,1,0,0,2
2012,21130,PIT,2,1,2,0,0,5
2012,21131,CHI,0,0,1,0,0,1
2012,21131,NSH,2,1,3,0,0,6
2012,21132,ANA,0,1,1,0,0,2
2012,21132,BOS,0,2,1,0,0,3
2012,21133,PHX,0,0,0,0,0,0
2012,21133,STL,0,1,3,0,0,4
2012,21134,PHI,0,2,1,0,0,3
2012,21134,TBL,2,0,3,0,0,5
2012,21135,CBJ,0,0,2,0,0,2
2012,21135,DET,4,2,1,0,0,7
2012,21136,OTT,1,2,3,0,0,6
2012,21136,WPG,0,3,1,0,0,4
2012,21137,CGY,1,4,0,0,0,5
2012,21137,DAL,1,2,1,0,0,4
2012,21138,LAK,0,0,0,0,0,0
2012,21138,VAN,1,0,0,0,0,1
2012,21139,COL,0,1,0,0,0,1
2012,21139,SJS,0,3,2,0,0,5
2012,21140,BOS,1,1,3,0,0,5
2012,21140,TBL,1,0,1,0,0,2
2012,21141,CAR,2,1,0,0,0,3
2012,21141,TOR,0,0,0,0,0,0
2012,21142,CHI,0,0,1,0,0,1
2012,21142,NJD,1,0,0,0,1,2
2012,21143,NYI,2,3,0,0,0,5
2012,21143,PIT,0,2,1,0,0,3
2012,21144,BUF,2,2,1,0,0,5
2012,21144,WSH,0,1,0,0,0,1
2012,21145,FLA,1,0,1,0,1,3
2012,21145,MTL,1,1,0,0,0,2
2012,21146,NSH,0,0,0,0,0,0
2012,21146,STL,0,1,2,0,0,3
2012,21147,MIN,0,2,0,0,0,2
2012,21147,NYR,1,1,1,0,0,3
2012,21148,NYR,0,2,2,0,0,4
2012,21148,WPG,0,2,0,0,0,2
2012,21149,CBJ,2,2,0,0,0,4
2012,21149,DET,1,0,1,0,0,2
2012,21150,CGY,0,0,0,0,0,0
2012,21150,LAK,1,1,1,0,0,3
2012,21151,DAL,1,1,1,0,0,3
2012,21151,EDM,0,0,1,0,0,1
2012,21152,COL,0,0,0,0,0,0
2012,21152,VAN,1,0,0,0,0,1
2012,21153,ANA,0,1,2,0,0,3
2012,21153,SJS,0,1,0,0,0,1
2012,21154,BOS,0,0,2,0,0,2
2012,21154,WSH,0,0,2,0,1,3
2012,21155,PHI,2,2,3,0,0,7
2012,21155,TOR,1,0,0,0,0,1
2012,21156,NJD,0,4,2,0,0,6
2012,21156,TBL,1,2,1,0,0,4
2012,21157,NYI,1,2,2,0,0,5
2012,21157,PIT,0,1,2,0,0,3
2012,21158,FLA,0,1,1,0,0,2
2012,21158,MIN,0,0,2,1,0,3
2012,21159,CHI,1,0,2,0,1,4
2012,21159,STL,1,0,2,0,0,3
2012,21160,PHX,0,1,1,0,0,2
2012,21160,SJS,0,0,0,0,0,0
2012,21161,MTL,0,0,1,0,0,1
2012,21161,NYR,1,1,2,0,0,4
2012,21162,CAR,2,1,0,0,0,3
2012,21162,WPG,1,1,1,1,0,4
2012,21163,CBJ,1,1,2,0,0,4
2012,21163,FLA,0,0,1,0,0,1
2012,21164,BUF,2,1,0,0,0,3
2012,21164,PIT,2,2,1,0,0,5
2012,21165,DET,0,0,1,0,0,1
2012,21165,NSH,0,2,2,0,0,4
2012,21166,CGY,0,0,1,0,0,1
2012,21166,COL,2,1,1,0,0,4
2012,21167,EDM,1,0,0,0,0,1
2012,21167,LAK,2,1,1,0,0,4
2012,21168,DAL,0,1,1,0,0,2
2012,21168,VAN,1,2,2,0,0,5
2012,21169,BOS,1,1,4,0,0,6
2012,21169,NYI,1,1,1,0,0,3
2012,21170,OTT,3,0,0,0,1,4
2012,21170,PHI,0,3,0,0,0,3
2012,21171,BUF,0,1,2,0,0,3
2012,21171,TOR,1,2,1,0,0,4
2012,21172,MTL,1,1,0,0,0,2
2012,21172,WSH,2,0,0,0,1,3
2012,21173,CAR,0,0,0,0,0,0
2012,21173,NJD,1,3,1,0,0,5
2012,21174,TBL,1,0,1,1,0,3
2012,21174,WPG,0,2,0,0,0,2
2012,21175,CBJ,2,1,2,0,0,5
2012,21175,STL,1,1,0,0,0,2
2012,21176,CHI,1,3,1,0,0,5
2012,21176,NSH,0,2,2,0,0,4
2012,21177,LAK,2,1,0,0,0,3
2012,21177,MIN,2,0,1,0,1,4
2012,21178,ANA,0,0,0,0,0,0
2012,21178,PHX,1,3,0,0,0,4
2012,21179,CGY,0,1,1,0,0,2
2012,21179,VAN,1,0,1,1,0,3
2012,21180,DAL,0,0,0,0,0,0
2012,21180,SJS,2,1,0,0,0,3
2012,21181,NYI,1,0,0,0,0,1
2012,21181,OTT,1,3,1,0,0,5
2012,21182,BOS,0,2,0,0,0,2
2012,21182,NYR,1,0,0,0,0,1
2012,21183,DET,0,0,1,0,1,2
2012,21183,FLA,1,0,0,0,0,1
2012,21184,CHI,1,2,1,0,0,4
2012,21184,MIN,2,2,0,0,1,5
2012,21185,PHI,1,1,4,0,0,6
2012,21185,PIT,2,0,2,0,0,4
2012,21186,ANA,1,0,0,0,0,1
2012,21186,EDM,2,0,0,0,0,2
2012,21187,TBL,0,2,2,0,0,4
2012,21187,WSH,0,1,1,0,0,2
2012,21188,EDM,0,0,0,0,0,0
2012,21188,LAK,0,0,2,0,0,2
2012,21189,BOS,1,1,1,0,0,3
2012,21189,PIT,2,2,1,0,0,5
2012,21190,BUF,0,2,3,1,0,6
2012,21190,TOR,3,0,2,0,0,5
2012,21191,NJD,1,1,1,0,0,3
2012,21191,NYI,1,0,0,0,0,1
2012,21192,NYR,4,1,0,0,0,5
2012,21192,PHI,0,2,1,0,0,3
2012,21193,CAR,0,2,0,0,0,2
2012,21193,OTT,0,0,1,0,0,1
2012,21194,FLA,2,1,1,0,0,4
2012,21194,WPG,0,2,2,1,0,5
2012,21195,MIN,0,1,0,0,0,1
2012,21195,NSH,0,1,0,0,1,2
2012,21196,DAL,1,1,0,0,0,2
2012,21196,SJS,1,2,2,0,0,5
2012,21197,ANA,2,2,0,0,0,4
2012,21197,VAN,2,2,0,0,1,5
2012,21198,CBJ,0,0,0,0,0,0
2012,21198,PHX,0,2,0,0,0,2
2012,21199,MTL,1,2,2,0,0,5
2012,21199,TBL,1,0,1,0,0,2
2012,21200,DET,0,0,2,0,1,3
2012,21200,STL,0,0,2,0,0,2
2012,21201,TBL,1,0,1,0,0,2
2012,21201,TOR,1,0,1,1,0,3
2012,21202,NYI,2,1,2,0,0,5
2012,21202,WPG,2,0,2,0,0,4
2012,21203,BUF,0,1,0,0,0,1
2012,21203,PHI,0,0,2,0,0,2
2012,21204,NYR,1,0,1,0,0,2
2012,21204,PIT,2,1,2,0,0,5
2012,21205,FLA,0,1,1,0,0,2
2012,21205,WSH,1,2,1,0,0,4
2012,21206,CAR,0,1,0,0,1,2
2012,21206,MTL,0,1,0,0,0,1
2012,21207,BOS,1,1,1,0,0,3
2012,21207,OTT,0,1,0,0,0,1
2012,21208,DET,0,1,0,0,0,1
2012,21208,NJD,1,0,1,0,0,2
2012,21209,DAL,0,0,0,0,0,0
2012,21209,NSH,0,0,2,0,0,2
2012,21210,CHI,1,0,0,0,0,1
2012,21210,MIN,0,0,1,0,1,2
2012,21211,COL,1,1,0,0,0,2
2012,21211,CBJ,2,2,1,0,0,5
2012,21212,CGY,0,0,3,0,0,3
2012,21212,VAN,1,0,1,0,0,2
2012,21213,ANA,0,2,0,1,0,3
2012,21213,EDM,0,1,1,0,0,2
2012,21214,LAK,1,2,2,0,0,5
2012,21214,SJS,1,1,3,0,1,6
2012,21215,PHX,1,2,1,0,0,4
2012,21215,STL,1,0,0,0,0,1
2012,21216,BOS,0,1,2,0,1,4
2012,21216,BUF,0,1,2,0,0,3
2012,21217,NJD,1,1,2,0,0,4
2012,21217,OTT,1,1,0,0,0,2
2012,21218,NYR,0,1,0,0,0,1
2012,21218,WSH,3,1,0,0,0,4
2012,21219,PHI,1,1,0,0,0,2
2012,21219,PIT,1,3,0,0,0,4
2012,21220,CHI,1,1,0,0,1,3
2012,21220,DET,0,0,2,0,0,2
2012,21221,ANA,0,1,1,0,0,2
2012,21221,CGY,1,2,2,0,0,5
2012,21222,MTL,1,1,2,0,0,4
2012,21222,TOR,0,0,1,0,0,1
2012,21223,TBL,1,1,1,1,0,4
2012,21223,WPG,0,1,2,0,0,3
2012,21224,CBJ,1,4,2,0,0,7
2012,21224,NYI,0,2,1,0,0,3
2012,21225,CAR,0,0,1,0,0,1
2012,21225,FLA,2,1,1,0,0,4
2012,21226,MIN,0,1,0,0,0,1
2012,21226,PHX,2,1,1,0,0,4
2012,21227,DAL,0,0,2,0,0,2
2012,21227,STL,0,1,2,0,0,3
2012,21228,COL,1,0,0,0,0,1
2012,21228,NSH,3,1,2,0,0,6
2012,21229,EDM,0,0,0,0,0,0
2012,21229,VAN,0,1,2,0,0,3
2012,21230,LAK,1,1,0,0,0,2
2012,21230,SJS,0,0,2,1,0,3
